index,Scratched,Breakage,Separated,Crushed,total_anns,ran_var,dataset
0000002_as-0036229.jpg,0,1,0,0,1,0,train
0000268_sc-1003791.jpg,1,1,0,1,3,0,train
0000051_as-0082746.jpg,4,0,0,1,5,0,train
0000576_as-7572528.jpg,1,0,0,0,1,0,train
0000328_as-0065081.jpg,2,0,0,0,2,0,train
0000574_as-0032287.jpg,4,0,2,0,6,0,val
0000491_as-0037513.jpg,11,0,1,0,12,0,test
0000170_sc-113989.jpg,3,1,0,0,4,0,train
0000438_sc-164159.jpg,1,0,0,0,1,0,train
0000563_sc-163434.jpg,2,0,1,0,3,0,train
0000441_as-0039802.jpg,0,1,2,0,3,0,train
0000593_as-0081233.jpg,1,0,0,0,1,0,train
0000210_sc-132140.jpg,1,0,0,0,1,0,val
0000592_as-0081233.jpg,1,0,0,0,1,0,test
0000239_sc-1018546.jpg,4,0,0,0,4,0,train
0000483_as-0037513.jpg,10,0,2,1,13,0,train
0000556_sc-192822.jpg,1,0,0,0,1,0,train
0000307_as-3071260.jpg,4,0,0,0,4,0,train
0000432_sc-164159.jpg,4,0,0,1,5,0,train
0000337_as-0071201.jpg,2,0,0,0,2,0,val
0000039_as-0096878.jpg,0,0,3,0,3,0,test
0000330_as-0065081.jpg,1,0,0,0,1,0,train
0000207_sc-132140.jpg,5,0,2,0,7,0,train
0000128_as-9085678.jpg,1,1,0,0,2,0,train
0000012_sc-182987.jpg,1,0,0,0,1,0,train
0000485_as-0037513.jpg,4,0,1,0,5,0,train
0000295_sc-189219.jpg,2,0,0,0,2,0,val
0000586_sc-203269.jpg,3,0,0,0,3,0,test
0000584_sc-203269.jpg,2,0,0,0,2,0,train
0000177_sc-153567.jpg,3,1,1,1,6,0,train
0000007_as-0036229.jpg,0,0,1,0,1,0,train
0000470_as-0046174.jpg,2,0,1,0,3,0,train
0000211_sc-132140.jpg,1,0,0,0,1,0,train
0000316_as-0075428.jpg,2,1,0,1,4,0,val
0000241_sc-1018546.jpg,4,0,0,0,4,0,test
0000158_as-0026634.jpg,4,0,0,0,4,0,train
0000308_sc-180027.jpg,1,0,0,0,1,0,train
0000468_as-0046174.jpg,2,0,1,0,3,0,train
0000045_as-0082746.jpg,1,0,0,0,1,0,train
0000236_as-3053999.jpg,1,0,0,0,1,0,train
0000462_as-0046174.jpg,1,0,0,0,1,0,val
0000338_as-0071201.jpg,2,0,0,0,2,0,test
0000473_as-0046174.jpg,0,0,2,0,2,0,train
0000075_as-0035111.jpg,0,1,1,0,2,0,train
0000344_as-0037937.jpg,1,0,0,0,1,0,train
0000396_as-0046441.jpg,6,3,0,0,9,0,train
0000025_sc-203122.jpg,3,0,1,0,4,0,train
0000246_as-0086370.jpg,1,0,0,1,2,0,val
0000356_as-0061741.jpg,1,0,0,0,1,0,test
0000173_sc-120410.jpg,7,1,0,0,8,0,train
0000348_as-0000088.jpg,0,0,0,1,1,0,train
0000559_as-7084873.jpg,2,1,0,1,4,0,train
0000386_sc-156350.jpg,4,0,1,2,7,0,train
0000313_as-0075428.jpg,1,2,2,2,7,0,train
0000172_sc-120410.jpg,5,0,0,0,5,0,val
0000108_as-0036033.jpg,2,0,0,0,2,0,test
0000314_as-0075428.jpg,0,2,2,1,5,0,train
0000523_sc-1030492.jpg,2,0,1,1,4,0,train
0000502_as-2673966.jpg,1,3,1,2,7,0,train
0000444_sc-108178.jpg,1,0,0,0,1,0,train
0000588_sc-203269.jpg,2,0,0,0,2,0,train
0000090_sc-165613.jpg,0,0,1,0,1,0,val
0000445_sc-108178.jpg,1,0,0,0,1,0,test
0000286_as-0001700.jpg,2,0,2,0,4,0,train
0000009_sc-186320.jpg,4,2,1,0,7,0,train
0000554_sc-192822.jpg,10,0,0,0,10,0,train
0000531_as-2933655.jpg,3,0,0,0,3,0,train
0000303_as-0049932.jpg,1,0,0,0,1,0,train
0000433_sc-164159.jpg,5,0,0,0,5,0,val
0000435_sc-164159.jpg,2,0,1,0,3,0,test
0000362_as-0061741.jpg,2,0,0,0,2,0,train
0000499_as-0098602.jpg,2,0,1,1,4,0,train
0000508_as-0074167.jpg,1,1,1,1,4,0,train
0000107_as-0036033.jpg,1,0,0,0,1,0,train
0000079_as-3062539.jpg,1,0,0,0,1,0,train
0000420_as-0039880.jpg,3,2,1,1,7,0,val
0000429_sc-160114.jpg,4,0,1,0,5,0,test
0000456_sc-223105.jpg,6,0,1,1,8,0,train
0000528_as-0081945.jpg,1,0,0,0,1,0,train
0000479_as-3045041.jpg,3,0,0,1,4,0,train
0000263_sc-198884.jpg,1,1,0,0,2,0,train
0000460_sc-191424.jpg,3,0,0,0,3,0,train
0000118_sc-189301.jpg,1,0,0,1,2,0,val
0000315_as-0075428.jpg,1,0,0,0,1,0,test
0000197_as-0013197.jpg,1,0,0,0,1,0,train
0000494_sc-212414.jpg,3,1,1,0,5,0,train
0000590_sc-193314.jpg,1,0,0,0,1,0,train
0000285_as-0001700.jpg,1,0,0,0,1,0,train
0000215_sc-203166.jpg,1,2,0,0,3,0,train
0000573_as-3041918.jpg,1,1,0,0,2,0,val
0000248_as-3126277.jpg,0,1,0,0,1,0,test
0000577_sc-129920.jpg,5,0,0,0,5,0,train
0000092_sc-165613.jpg,2,1,0,0,3,0,train
0000235_as-3258449.jpg,1,0,0,0,1,0,train
0000310_as-0063226.jpg,1,1,0,0,2,0,train
0000147_sc-211946.jpg,2,0,1,0,3,0,train
0000547_sc-145666.jpg,0,1,0,0,1,0,val
0000332_as-0065081.jpg,2,0,0,0,2,0,test
0000219_sc-156030.jpg,3,0,0,0,3,0,train
0000066_as-0011123.jpg,2,0,1,0,3,0,train
0000371_as-0061741.jpg,3,0,0,0,3,0,train
0000426_sc-1007428.jpg,0,0,0,1,1,0,train
0000466_as-0046174.jpg,3,0,2,0,5,0,train
0000282_as-0001700.jpg,3,0,1,0,4,0,val
0000425_sc-1007428.jpg,2,0,0,0,2,0,test
0000200_as-0013197.jpg,1,1,0,1,3,0,train
0000069_as-2804918.jpg,3,0,0,1,4,0,train
0000242_sc-1018546.jpg,2,0,0,0,2,0,train
0000277_sc-217487.jpg,2,0,0,0,2,0,train
0000520_sc-1030492.jpg,2,0,1,1,4,0,train
0000005_as-0036229.jpg,1,0,0,0,1,0,val
0000598_sc-186900.jpg,1,0,0,0,1,0,test
0000471_as-0046174.jpg,1,0,1,0,2,0,train
0000384_sc-156350.jpg,3,0,3,3,9,0,train
0000225_sc-114703.jpg,1,0,1,0,2,0,train
0000023_sc-149923.jpg,3,0,1,0,4,0,train
0000529_as-9050821.jpg,1,0,1,0,2,0,train
0000119_as-2902166.jpg,2,0,0,0,2,0,val
0000244_as-3441097.jpg,2,0,0,1,3,0,test
0000104_as-2655606.jpg,1,0,0,0,1,0,train
0000106_as-0036033.jpg,1,0,0,0,1,0,train
0000367_as-0061741.jpg,1,0,0,0,1,0,train
0000535_sc-161150.jpg,1,0,0,0,1,0,train
0000143_as-7732212.jpg,1,0,0,0,1,0,train
0000256_as-2964247.jpg,2,0,0,0,2,0,val
0000102_as-0059752.jpg,1,0,1,2,4,0,test
0000299_as-0068039.jpg,1,0,2,0,3,0,train
0000553_as-2785889.jpg,3,0,0,0,3,0,train
0000076_as-0035111.jpg,0,1,0,1,2,0,train
0000181_as-3104502.jpg,3,0,1,0,4,0,train
0000272_sc-217487.jpg,2,0,0,0,2,0,train
0000087_sc-1038787.jpg,1,2,0,0,3,0,val
0000401_as-0055160.jpg,2,0,0,0,2,0,test
0000265_sc-198884.jpg,0,1,0,0,1,0,train
0000381_as-0035963.jpg,6,0,0,0,6,0,train
0000047_as-0082746.jpg,2,0,0,1,3,0,train
0000393_as-0046441.jpg,3,2,0,0,5,0,train
0000532_as-0086378.jpg,1,3,2,0,6,0,train
0000065_sc-227004.jpg,3,0,0,0,3,0,val
0000461_sc-191424.jpg,2,0,0,0,2,0,test
0000157_as-0026634.jpg,5,0,1,0,6,0,train
0000358_as-0061741.jpg,2,0,0,0,2,0,train
0000046_as-0082746.jpg,1,0,0,1,2,0,train
0000204_sc-228365.jpg,3,0,0,0,3,0,train
0000150_sc-211946.jpg,2,0,0,0,2,0,train
0000243_sc-1018546.jpg,2,0,0,1,3,0,val
0000281_sc-217487.jpg,1,0,0,0,1,0,test
0000194_as-0013197.jpg,4,0,0,0,4,0,train
0000057_as-0082746.jpg,6,0,0,1,7,0,train
0000546_sc-145666.jpg,0,1,0,0,1,0,train
0000481_as-0037513.jpg,0,0,2,0,2,0,train
0000105_as-0036033.jpg,2,0,0,0,2,0,train
0000178_sc-207883.jpg,1,1,0,0,2,0,val
0000463_as-0046174.jpg,2,0,0,0,2,0,test
0000071_as-0058182.jpg,1,0,0,0,1,0,train
0000538_as-7303892.jpg,1,1,2,1,5,0,train
0000205_sc-228365.jpg,2,0,0,0,2,0,train
0000397_as-3494121.jpg,2,0,0,0,2,0,train
0000301_as-0049932.jpg,1,0,0,0,1,0,train
0000206_sc-228365.jpg,1,0,0,0,1,0,val
0000061_sc-196153.jpg,1,2,0,0,3,0,test
0000488_as-0037513.jpg,2,0,1,0,3,0,train
0000070_as-0058182.jpg,3,2,1,0,6,0,train
0000443_sc-108178.jpg,1,0,0,0,1,0,train
0000088_sc-165613.jpg,2,0,1,0,3,0,train
0000342_as-0037937.jpg,1,0,0,0,1,0,train
0000055_as-0082746.jpg,2,0,0,0,2,0,val
0000496_sc-212414.jpg,1,1,1,0,3,0,test
0000564_sc-163434.jpg,2,0,1,0,3,0,train
0000326_sc-118402.jpg,5,1,0,2,8,0,train
0000132_as-0070095.jpg,1,1,0,1,3,0,train
0000294_as-7545335.jpg,6,0,1,0,7,0,train
0000125_as-0038448.jpg,1,1,0,0,2,0,train
0000149_sc-211946.jpg,2,0,0,0,2,0,val
0000391_as-0046441.jpg,3,2,0,0,5,0,test
0000035_as-0076498.jpg,2,2,1,0,5,0,train
0000513_sc-124621.jpg,1,1,1,1,4,0,train
0000026_sc-222547.jpg,2,0,0,0,2,0,train
0000064_sc-227004.jpg,4,0,0,0,4,0,train
0000138_sc-1019190.jpg,0,0,1,0,1,0,train
0000361_as-0061741.jpg,2,0,0,0,2,0,val
0000003_as-0036229.jpg,0,1,0,0,1,0,test
0000390_as-0046441.jpg,1,0,0,0,1,0,train
0000199_as-0013197.jpg,2,0,0,0,2,0,train
0000052_as-0082746.jpg,2,0,0,1,3,0,train
0000020_as-0035991.jpg,1,0,1,0,2,0,train
0000506_as-0074167.jpg,3,0,1,0,4,0,train
0000169_sc-113989.jpg,2,1,0,0,3,0,val
0000450_sc-1020282.jpg,3,0,0,1,4,0,test
0000302_as-0049932.jpg,1,0,0,0,1,0,train
0000587_sc-203269.jpg,2,0,0,0,2,0,train
0000251_sc-1026080.jpg,2,0,0,0,2,0,train
0000487_as-0037513.jpg,1,0,1,0,2,0,train
0000227_as-2718250.jpg,2,0,0,0,2,0,train
0000144_sc-211946.jpg,1,0,0,0,1,0,val
0000209_sc-132140.jpg,1,0,0,0,1,0,test
0000093_as-3278159.jpg,2,1,0,3,6,0,train
0000230_sc-214555.jpg,2,0,0,0,2,0,train
0000080_as-3373673.jpg,1,0,0,0,1,0,train
0000074_as-0035111.jpg,1,1,0,0,2,0,train
0000264_sc-198884.jpg,0,1,0,0,1,0,train
0000167_as-0092475.jpg,3,1,1,0,5,0,val
0000591_sc-193314.jpg,2,0,0,0,2,0,test
0000541_sc-156063.jpg,2,1,0,0,3,0,train
0000179_sc-208581.jpg,3,1,0,0,4,0,train
0000140_as-2963821.jpg,1,0,1,0,2,0,train
0000363_as-0061741.jpg,1,0,0,0,1,0,train
0000339_as-0071201.jpg,1,0,0,0,1,0,train
0000021_as-0035991.jpg,1,0,1,0,2,0,val
0000168_as-0092475.jpg,2,1,1,0,4,0,test
0000355_as-2880539.jpg,4,1,0,0,5,0,train
0000213_sc-132140.jpg,1,0,0,0,1,0,train
0000510_sc-124621.jpg,2,1,0,1,4,0,train
0000267_sc-1003791.jpg,1,0,0,1,2,0,train
0000139_as-3498608.jpg,3,0,0,0,3,0,train
0000469_as-0046174.jpg,3,0,1,0,4,0,val
0000159_as-2884367.jpg,1,0,0,0,1,0,test
0000114_sc-169959.jpg,1,0,0,0,1,0,train
0000163_sc-143033.jpg,1,0,0,0,1,0,train
0000214_sc-203166.jpg,1,2,0,0,3,0,train
0000232_sc-214555.jpg,2,0,0,1,3,0,train
0000329_as-0065081.jpg,4,0,0,0,4,0,train
0000421_as-0039880.jpg,2,1,1,0,4,0,val
0000459_sc-226797.jpg,0,0,1,0,1,0,test
0000403_as-0035224.jpg,3,1,1,0,5,0,train
0000049_as-0082746.jpg,5,0,0,1,6,0,train
0000237_as-2808541.jpg,1,1,2,1,5,0,train
0000029_sc-222547.jpg,0,0,0,1,1,0,train
0000022_as-0035991.jpg,1,0,1,1,3,0,train
0000375_sc-155490.jpg,6,0,1,0,7,0,val
0000475_as-0035422.jpg,4,0,0,1,5,0,test
0000072_as-0058182.jpg,1,1,0,0,2,0,train
0000542_sc-156063.jpg,1,0,2,0,3,0,train
0000067_sc-180383.jpg,1,0,0,0,1,0,train
0000284_as-0001700.jpg,2,0,1,0,3,0,train
0000524_as-0081945.jpg,1,0,0,0,1,0,train
0000304_sc-216541.jpg,1,1,2,1,5,0,val
0000585_sc-203269.jpg,3,0,0,0,3,0,test
0000596_sc-1033302.jpg,1,0,0,1,2,0,train
0000259_sc-198884.jpg,2,0,0,1,3,0,train
0000189_as-2916179.jpg,1,0,0,0,1,0,train
0000164_sc-143033.jpg,1,0,0,0,1,0,train
0000203_as-0002449.jpg,1,0,0,0,1,0,train
0000091_sc-165613.jpg,2,1,0,0,3,0,val
0000385_sc-156350.jpg,4,0,1,2,7,0,test
0000262_sc-198884.jpg,1,0,0,0,1,0,train
0000550_sc-158380.jpg,1,0,1,0,2,0,train
0000033_sc-130458.jpg,1,1,2,1,5,0,train
0000190_sc-1007251.jpg,2,0,0,0,2,0,train
0000551_as-3207917.jpg,1,0,0,0,1,0,train
0000109_as-3015422.jpg,3,0,1,0,4,0,val
0000283_as-0001700.jpg,2,0,2,0,4,0,test
0000351_sc-140575.jpg,1,1,1,0,3,0,train
0000352_sc-140575.jpg,1,1,0,0,2,0,train
0000507_as-0074167.jpg,2,0,1,0,3,0,train
0000447_sc-1020282.jpg,1,0,2,2,5,0,train
0000594_sc-107785.jpg,1,0,0,0,1,0,train
0000222_sc-114703.jpg,1,0,1,1,3,0,val
0000135_sc-1019190.jpg,1,0,0,0,1,0,test
0000442_sc-218792.jpg,1,0,0,1,2,0,train
0000254_sc-1024306.jpg,1,0,0,0,1,0,train
0000275_sc-217487.jpg,1,0,0,0,1,0,train
0000188_as-0064745.jpg,0,0,1,0,1,0,train
0000325_sc-153212.jpg,6,0,0,0,6,0,train
0000544_sc-145666.jpg,0,1,0,0,1,0,val
0000579_sc-129920.jpg,4,0,1,1,6,0,test
0000305_sc-216541.jpg,0,0,1,0,1,0,train
0000120_as-7549899.jpg,7,1,1,1,10,0,train
0000160_sc-143033.jpg,1,0,0,0,1,0,train
0000261_sc-198884.jpg,2,0,0,0,2,0,train
0000116_sc-169959.jpg,1,0,0,0,1,0,train
0000117_sc-189301.jpg,1,0,0,1,2,0,val
0000321_as-3288847.jpg,1,0,1,1,3,0,test
0000430_as-7047994.jpg,1,0,0,0,1,0,train
0000345_as-0037937.jpg,1,0,0,0,1,0,train
0000458_sc-223105.jpg,9,0,1,1,11,0,train
0000465_as-0046174.jpg,5,0,1,0,6,0,train
0000260_sc-198884.jpg,1,0,0,0,1,0,train
0000449_sc-1020282.jpg,1,0,1,0,2,0,val
0000376_as-0035963.jpg,0,1,0,0,1,0,test
0000448_sc-1020282.jpg,0,0,1,0,1,0,train
0000549_sc-158380.jpg,5,0,1,0,6,0,train
0000110_as-3070171.jpg,6,0,0,0,6,0,train
0000557_sc-192822.jpg,1,0,0,0,1,0,train
0000137_sc-1019190.jpg,1,0,0,0,1,0,train
0000280_sc-217487.jpg,2,0,0,0,2,0,val
0000082_as-3177630.jpg,1,0,1,0,2,0,test
0000296_sc-189219.jpg,1,0,1,0,2,0,train
0000472_as-0046174.jpg,4,0,1,0,5,0,train
0000439_as-0039802.jpg,2,0,1,0,3,0,train
0000153_sc-160019.jpg,4,0,0,0,4,0,train
0000212_sc-132140.jpg,1,0,0,0,1,0,train
0000477_as-3232005.jpg,1,0,1,0,2,0,val
0000453_as-0056313.jpg,2,1,0,0,3,0,test
0000411_as-7514387.jpg,1,0,0,0,1,0,train
0000374_sc-155490.jpg,2,0,1,0,3,0,train
0000030_sc-222547.jpg,1,0,1,0,2,0,train
0000250_sc-1026080.jpg,2,0,0,0,2,0,train
0000060_sc-196153.jpg,0,1,0,0,1,0,train
0000245_as-0086370.jpg,2,0,0,1,3,0,val
0000134_as-9016901.jpg,1,1,0,1,3,0,test
0000451_as-3223817.jpg,3,0,0,1,4,0,train
0000514_sc-196193.jpg,4,0,1,0,5,0,train
0000464_as-0046174.jpg,4,0,0,0,4,0,train
0000595_sc-1033302.jpg,4,0,0,1,5,0,train
0000017_as-2579102.jpg,2,2,0,0,4,0,train
0000183_as-0064745.jpg,2,0,0,0,2,0,val
0000552_as-0035392.jpg,2,0,0,0,2,0,test
0000287_as-0001700.jpg,3,1,2,0,6,0,train
0000394_as-0046441.jpg,3,2,0,0,5,0,train
0000354_as-0096209.jpg,4,0,0,0,4,0,train
0000476_as-3233849.jpg,1,0,0,0,1,0,train
0000436_sc-164159.jpg,1,0,1,0,2,0,train
0000223_sc-114703.jpg,1,0,1,1,3,0,val
0000083_as-3344239.jpg,1,1,2,1,5,0,test
0000208_sc-132140.jpg,1,0,0,1,2,0,train
0000359_as-0061741.jpg,3,0,0,0,3,0,train
0000395_as-0046441.jpg,2,0,1,0,3,0,train
0000162_sc-143033.jpg,1,0,0,0,1,0,train
0000414_sc-133902.jpg,2,1,2,2,7,0,train
0000373_as-9093407.jpg,2,0,0,0,2,0,val
0000505_as-0074167.jpg,5,1,1,0,7,0,test
0000216_as-2583257.jpg,1,0,0,0,1,0,train
0000489_as-0037513.jpg,9,0,1,1,11,0,train
0000247_as-0086370.jpg,1,0,0,1,2,0,train
0000575_as-0032287.jpg,3,0,0,0,3,0,train
0000011_sc-186320.jpg,4,2,0,0,6,0,train
0000422_as-0039880.jpg,1,1,1,0,3,0,val
0000567_sc-1036659.jpg,3,1,1,0,5,0,test
0000231_sc-214555.jpg,4,0,0,1,5,0,train
0000467_as-0046174.jpg,5,0,2,0,7,0,train
0000166_sc-1024516.jpg,1,0,0,0,1,0,train
0000085_sc-108575.jpg,11,2,1,2,16,0,train
0000288_as-0001700.jpg,1,0,1,0,2,0,train
0000580_sc-129920.jpg,3,0,0,1,4,0,val
0000032_sc-130458.jpg,1,1,2,1,5,0,test
0000353_as-0096209.jpg,4,0,0,0,4,0,train
0000081_sc-1031751.jpg,3,0,0,0,3,0,train
0000569_sc-1036659.jpg,3,0,0,0,3,0,train
0000539_as-0033131.jpg,0,0,1,0,1,0,train
0000014_as-0031772.jpg,2,0,1,0,3,0,train
0000428_sc-160114.jpg,4,0,1,0,5,0,val
0000196_as-0013197.jpg,2,0,0,0,2,0,test
0000298_sc-105556.jpg,1,0,0,0,1,0,train
0000175_sc-120410.jpg,3,0,1,1,5,0,train
0000399_as-7581919.jpg,3,2,2,0,7,0,train
0000370_as-0061741.jpg,1,0,0,0,1,0,train
0000377_as-0035963.jpg,2,0,0,0,2,0,train
0000127_as-0038448.jpg,1,1,0,0,2,0,val
0000217_sc-156030.jpg,3,0,0,0,3,0,test
0000291_as-0064257.jpg,5,0,1,0,6,0,train
0000402_as-0035224.jpg,5,2,2,0,9,0,train
0000565_sc-163434.jpg,9,0,0,0,9,0,train
0000027_sc-222547.jpg,1,0,0,1,2,0,train
0000113_sc-169959.jpg,2,0,0,0,2,0,train
0000131_as-0070095.jpg,1,1,0,1,3,0,val
0000221_sc-114703.jpg,1,0,1,0,2,0,test
0000036_as-0076498.jpg,1,0,0,0,1,0,train
0000495_sc-212414.jpg,4,1,2,0,7,0,train
0000034_as-0076498.jpg,3,2,1,0,6,0,train
0000407_as-0035224.jpg,3,1,1,0,5,0,train
0000522_sc-1030492.jpg,3,0,0,0,3,0,train
0000578_sc-129920.jpg,6,0,1,0,7,0,val
0000124_as-0038448.jpg,1,0,0,0,1,0,test
0000480_as-0037513.jpg,1,1,2,0,4,0,train
0000498_as-0098602.jpg,2,0,1,1,4,0,train
0000369_as-0061741.jpg,3,0,0,0,3,0,train
0000146_sc-211946.jpg,2,0,0,0,2,0,train
0000501_as-0098602.jpg,0,0,1,1,2,0,train
0000297_sc-105556.jpg,2,0,0,0,2,0,val
0000155_sc-160019.jpg,7,1,0,0,8,0,test
0000184_as-0064745.jpg,1,0,0,0,1,0,train
0000229_sc-214555.jpg,1,1,0,0,2,0,train
0000534_sc-161150.jpg,1,0,0,0,1,0,train
0000224_sc-114703.jpg,1,0,1,0,2,0,train
0000290_sc-136432.jpg,0,1,0,0,1,0,train
0000548_as-3347867.jpg,5,1,0,0,6,0,val
0000583_sc-203269.jpg,1,0,0,0,1,0,test
0000319_as-7530260.jpg,0,0,1,0,1,0,train
0000238_sc-222899.jpg,1,0,0,0,1,0,train
0000186_as-0064745.jpg,3,0,0,1,4,0,train
0000536_sc-162189.jpg,3,0,0,0,3,0,train
0000454_as-0088988.jpg,1,0,0,0,1,0,train
0000195_as-0013197.jpg,2,0,0,0,2,0,val
0000406_as-0035224.jpg,3,0,0,1,4,0,test
0000509_sc-124621.jpg,1,1,1,2,5,0,train
0000418_as-7053320.jpg,1,1,0,0,2,0,train
0000255_sc-1024306.jpg,2,0,0,0,2,0,train
0000423_sc-1007428.jpg,1,0,0,1,2,0,train
0000068_as-2850000.jpg,1,0,0,0,1,0,train
0000226_sc-197291.jpg,1,2,0,0,3,0,val
0000220_sc-114703.jpg,1,0,1,1,3,0,test
0000233_sc-214555.jpg,1,0,1,0,2,0,train
0000187_as-0064745.jpg,2,0,0,0,2,0,train
0000379_as-0035963.jpg,4,0,0,0,4,0,train
0000300_as-0049932.jpg,1,0,0,0,1,0,train
0000484_as-0037513.jpg,2,0,0,0,2,0,train
0000568_sc-1036659.jpg,1,0,1,0,2,0,val
0000597_sc-1033302.jpg,1,0,0,1,2,0,test
0000112_as-7531621.jpg,3,2,1,0,6,0,train
0000050_as-0082746.jpg,2,0,0,1,3,0,train
0000346_as-0000088.jpg,1,0,0,0,1,0,train
0000311_as-0063226.jpg,2,1,0,0,3,0,train
0000408_as-0035224.jpg,7,1,4,0,12,0,train
0000013_as-0031772.jpg,3,0,1,0,4,0,val
0000089_sc-165613.jpg,3,0,1,0,4,0,test
0000457_sc-223105.jpg,6,0,1,1,8,0,train
0000582_as-0037616.jpg,3,0,0,0,3,0,train
0000474_as-0035422.jpg,2,0,0,1,3,0,train
0000145_sc-211946.jpg,3,0,1,0,4,0,train
0000228_sc-214555.jpg,1,1,1,0,3,0,train
0000041_as-0096878.jpg,0,1,0,1,2,0,val
0000278_sc-217487.jpg,2,0,0,0,2,0,test
0000493_sc-212414.jpg,1,0,1,0,2,0,train
0000279_sc-217487.jpg,1,0,0,0,1,0,train
0000518_sc-193337.jpg,4,0,0,0,4,0,train
0000516_sc-193337.jpg,2,0,0,0,2,0,train
0000148_sc-211946.jpg,3,0,1,0,4,0,train
0000151_as-9054191.jpg,1,0,2,0,3,0,val
0000409_as-0035224.jpg,5,2,3,0,10,0,test
0000193_as-0013197.jpg,1,0,0,0,1,0,train
0000572_as-3041918.jpg,0,0,0,1,1,0,train
0000521_sc-1030492.jpg,3,0,1,1,5,0,train
0000503_as-2889072.jpg,1,0,0,0,1,0,train
0000218_sc-156030.jpg,2,0,0,0,2,0,train
0000333_as-0065081.jpg,2,0,0,0,2,0,val
0000571_as-0066146.jpg,6,0,1,0,7,0,test
0000347_as-0000088.jpg,0,1,0,0,1,0,train
0000566_as-9019684.jpg,1,0,0,0,1,0,train
0000044_as-0082746.jpg,3,0,0,1,4,0,train
0000517_sc-193337.jpg,3,0,0,0,3,0,train
0000558_sc-192822.jpg,3,0,0,0,3,0,train
0000497_sc-212414.jpg,2,1,0,0,3,0,val
0000077_as-0035111.jpg,0,2,0,2,4,0,test
0000191_sc-1007251.jpg,2,0,0,0,2,0,train
0000378_as-0035963.jpg,1,0,0,0,1,0,train
0000142_as-0002692.jpg,2,0,1,1,4,0,train
0000152_as-3433967.jpg,6,3,0,1,10,0,train
0000455_as-0088988.jpg,1,0,0,0,1,0,train
0000098_sc-126705.jpg,5,2,0,0,7,0,val
0000417_as-2510418.jpg,1,0,0,0,1,0,test
0000073_as-0058182.jpg,1,1,0,0,2,0,train
0000266_sc-1003791.jpg,1,0,0,1,2,0,train
0000336_as-0071201.jpg,1,0,0,0,1,0,train
0000056_as-0082746.jpg,3,0,0,0,3,0,train
0000271_sc-1018026.jpg,0,1,1,0,2,0,train
0000198_as-0013197.jpg,2,0,0,0,2,0,val
0000192_sc-1007251.jpg,1,0,0,0,1,0,test
0000380_as-0035963.jpg,3,0,0,0,3,0,train
0000053_as-0082746.jpg,4,0,0,1,5,0,train
0000392_as-0046441.jpg,1,1,0,0,2,0,train
0000515_sc-196193.jpg,1,0,1,0,2,0,train
0000412_as-2804304.jpg,5,1,0,0,6,0,train
0000094_sc-126705.jpg,2,0,1,0,3,0,val
0000486_as-0037513.jpg,1,0,1,0,2,0,test
0000059_sc-196153.jpg,2,4,0,1,7,0,train
0000126_as-0038448.jpg,1,0,0,0,1,0,train
0000482_as-0037513.jpg,4,0,2,0,6,0,train
0000382_as-7560057.jpg,0,1,0,0,1,0,train
0000006_as-0036229.jpg,0,0,1,0,1,0,train
0000174_sc-120410.jpg,2,0,1,0,3,0,val
0000201_as-0013197.jpg,1,3,0,0,4,0,test
0000533_as-0086378.jpg,2,1,1,0,4,0,train
0000446_sc-108178.jpg,1,0,0,0,1,0,train
0000388_sc-156350.jpg,3,0,1,1,5,0,train
0000431_sc-164159.jpg,2,0,0,1,3,0,train
0000040_as-0096878.jpg,0,1,2,1,4,0,train
0000289_as-3275228.jpg,2,0,0,0,2,0,val
0000136_sc-1019190.jpg,2,0,0,0,2,0,test
0000478_as-0024758.jpg,2,0,0,0,2,0,train
0000165_sc-175181.jpg,1,0,2,1,4,0,train
0000540_sc-156063.jpg,1,0,2,0,3,0,train
0000276_sc-217487.jpg,1,0,0,0,1,0,train
0000028_sc-222547.jpg,1,0,0,1,2,0,train
0000270_sc-1018026.jpg,4,0,0,0,4,0,val
0000273_sc-217487.jpg,1,0,0,0,1,0,test
0000111_as-3324948.jpg,2,1,2,0,5,0,train
0000500_as-0098602.jpg,1,0,1,1,3,0,train
0000490_as-0037513.jpg,4,0,0,0,4,0,train
0000511_sc-124621.jpg,1,0,0,0,1,0,train
0000335_as-2788679.jpg,1,0,1,0,2,0,train
0000387_sc-156350.jpg,3,0,1,1,5,0,val
0000589_sc-193314.jpg,1,0,0,0,1,0,test
0000543_sc-145666.jpg,0,1,0,0,1,0,train
0000063_sc-196153.jpg,1,1,0,0,2,0,train
0000103_as-0059752.jpg,1,0,1,1,3,0,train
0000234_as-0032810.jpg,2,0,0,0,2,0,train
0000424_sc-1007428.jpg,2,0,0,0,2,0,train
0000130_as-0070095.jpg,1,0,0,1,2,0,val
0000570_sc-1036659.jpg,1,1,0,0,2,0,test
0000292_as-0064257.jpg,4,0,1,0,5,0,train
0000004_as-0036229.jpg,1,1,0,0,2,0,train
0000180_as-3392108.jpg,1,0,2,0,3,0,train
0000099_as-3036936.jpg,0,2,1,1,4,0,train
0000343_as-0037937.jpg,1,0,0,0,1,0,train
0000404_as-0035224.jpg,4,1,1,0,6,0,val
0000360_as-0061741.jpg,3,0,0,0,3,0,test
0000154_sc-160019.jpg,5,0,0,0,5,0,train
0000161_sc-143033.jpg,1,0,0,0,1,0,train
0000405_as-0035224.jpg,5,1,2,0,8,0,train