,index,Scratched,Breakage,Separated,Crushed,total_anns,ran_var,dataset
0,0506453_sc-155167.jpg,5,0,0,0,5,0,train
1,0506850_as-0031154.jpg,1,2,0,0,3,0,train
2,0506492_sc-201578.jpg,1,0,1,0,2,0,train
3,0506522_as-0014058.jpg,0,0,1,0,1,0,train
4,0506554_as-3339519.jpg,2,0,0,1,3,0,train
5,0506841_sc-157608.jpg,2,2,2,0,6,0,val
6,0506614_as-2657071.jpg,1,0,1,0,2,0,test
7,0506580_as-2952999.jpg,0,0,1,0,1,0,train
8,0506544_as-0070722.jpg,1,0,0,1,2,0,train
9,0506820_as-0049604.jpg,1,0,1,0,2,0,train
10,0506677_sc-1016158.jpg,1,0,0,0,1,0,train
11,0506812_as-3469891.jpg,1,0,1,0,2,0,train
12,0506852_sc-213030.jpg,1,0,0,0,1,0,val
13,0506468_as-0042089.jpg,1,0,0,1,2,0,test
14,0506556_sc-1015960.jpg,4,0,0,0,4,0,train
15,0506597_sc-214054.jpg,1,0,0,1,2,0,train
16,0506542_as-0070722.jpg,2,0,0,1,3,0,train
17,0506511_sc-205780.jpg,1,0,0,0,1,0,train
18,0506428_sc-123479.jpg,1,1,0,0,2,0,train
19,0506471_as-3407360.jpg,3,0,0,0,3,0,val
20,0506513_sc-205780.jpg,1,1,1,0,3,0,test
21,0506490_sc-201578.jpg,1,0,0,0,1,0,train
22,0506632_sc-118329.jpg,1,1,1,0,3,0,train
23,0506454_sc-115132.jpg,5,0,1,0,6,0,train
24,0506465_as-3335986.jpg,0,0,1,0,1,0,train
25,0506452_sc-155167.jpg,5,0,1,1,7,0,train
26,0506500_as-3278386.jpg,1,0,1,0,2,0,val
27,0506516_sc-1007334.jpg,5,0,1,0,6,0,test
28,0506476_sc-1014003.jpg,0,0,1,2,3,0,train
29,0506483_as-0024654.jpg,1,0,0,0,1,0,train
30,0506499_sc-226951.jpg,0,1,0,0,1,0,train
31,0506467_as-0042089.jpg,1,1,0,0,2,0,train
32,0506521_as-0014058.jpg,1,0,0,1,2,0,train
33,0506508_sc-205780.jpg,2,0,0,1,3,0,val
34,0506464_as-2977436.jpg,1,0,0,0,1,0,test
35,0506457_sc-115132.jpg,5,0,0,0,5,0,train
36,0506488_as-0050825.jpg,2,0,0,0,2,0,train
37,0506473_sc-1014003.jpg,1,1,1,0,3,0,train
38,0506495_sc-226951.jpg,3,0,0,0,3,0,train
39,0506498_sc-226951.jpg,2,1,1,1,5,0,train
40,0506493_sc-226951.jpg,1,1,0,1,3,0,val
41,0506496_sc-226951.jpg,1,0,0,0,1,0,test
42,0506451_sc-155167.jpg,1,0,0,0,1,0,train
43,0506514_sc-221241.jpg,2,0,0,0,2,0,train
44,0506505_sc-205780.jpg,7,0,0,0,7,0,train
45,0506477_as-5217561.jpg,3,0,0,0,3,0,train
46,0506462_as-3279903.jpg,1,0,0,1,2,0,train
47,0506515_sc-1007334.jpg,2,0,0,0,2,0,val
48,0506489_as-3317669.jpg,1,0,0,0,1,0,test
49,0506486_as-0050825.jpg,5,0,1,0,6,0,train
50,0506523_as-0014058.jpg,1,0,1,0,2,0,train
51,0506512_sc-205780.jpg,2,0,0,0,2,0,train
52,0506482_as-2592949.jpg,4,1,0,1,6,0,train
53,0506485_as-0050825.jpg,1,1,0,0,2,0,train
54,0506469_as-7525238.jpg,2,0,0,0,2,0,val
55,0506502_sc-205780.jpg,2,0,1,0,3,0,test
56,0506503_sc-205780.jpg,1,1,0,0,2,0,train
57,0506491_sc-201578.jpg,1,0,0,1,2,0,train
58,0506519_as-0014058.jpg,3,0,1,1,5,0,train
59,0506494_sc-226951.jpg,2,1,0,0,3,0,train
60,0506449_sc-155167.jpg,1,0,1,1,3,0,train
61,0506497_sc-226951.jpg,1,1,0,0,2,0,val
62,0506518_as-0014058.jpg,0,1,5,0,6,0,test
63,0506450_sc-155167.jpg,2,1,1,1,5,0,train
64,0506455_sc-115132.jpg,1,0,0,0,1,0,train
65,0506827_as-0049604.jpg,2,1,0,0,3,0,train
66,0506506_sc-205780.jpg,5,0,1,0,6,0,train
67,0506509_sc-205780.jpg,2,0,0,0,2,0,train
68,0506565_as-7670685.jpg,1,1,1,0,3,0,val
69,0506538_sc-215744.jpg,1,0,0,0,1,0,test
70,0506587_as-0095833.jpg,2,0,0,0,2,0,train
71,0506487_as-0050825.jpg,5,0,0,0,5,0,train
72,0506501_sc-205780.jpg,1,0,0,0,1,0,train
73,0506507_sc-205780.jpg,1,0,0,0,1,0,train
74,0506394_as-0049821.jpg,1,0,0,0,1,0,train
75,0506396_as-0049821.jpg,2,0,0,0,2,0,val
76,0506410_sc-201032.jpg,3,0,0,0,3,0,test
77,0506423_sc-160700.jpg,3,1,0,0,4,0,train
78,0506413_sc-201032.jpg,4,0,0,0,4,0,train
79,0506479_as-0004338.jpg,0,0,1,0,1,0,train
80,0506448_as-3292878.jpg,1,0,2,0,3,0,train
81,0506369_sc-1036355.jpg,2,0,0,0,2,0,train
82,0506375_sc-225312.jpg,1,0,0,0,1,0,val
83,0506414_sc-201032.jpg,2,3,1,1,7,0,test
84,0506421_sc-201032.jpg,1,1,0,1,3,0,train
85,0506409_sc-111021.jpg,2,0,0,0,2,0,train
86,0506422_as-0093056.jpg,2,0,0,0,2,0,train
87,0506406_sc-147276.jpg,3,0,0,0,3,0,train
88,0506408_sc-111021.jpg,2,0,0,0,2,0,train
89,0506415_sc-201032.jpg,4,1,2,1,8,0,val
90,0506412_sc-201032.jpg,2,2,1,1,6,0,test
91,0506411_sc-201032.jpg,0,0,0,2,2,0,train
92,0506418_sc-201032.jpg,3,0,1,0,4,0,train
93,0506437_as-3199886.jpg,1,0,0,0,1,0,train
94,0506510_sc-205780.jpg,1,0,1,0,2,0,train
95,0506433_sc-200938.jpg,2,0,0,1,3,0,train
96,0506435_as-3045299.jpg,2,1,0,0,3,0,val
97,0506458_sc-115132.jpg,3,0,0,2,5,0,test
98,0506480_as-0004338.jpg,1,0,0,0,1,0,train
99,0506444_as-0078573.jpg,1,0,0,0,1,0,train
100,0506504_sc-205780.jpg,1,0,0,0,1,0,train
101,0506425_as-2938861.jpg,0,0,1,0,1,0,train
102,0506434_sc-200938.jpg,4,0,0,0,4,0,train
103,0506481_as-0004338.jpg,1,0,2,0,3,0,val
104,0506517_sc-1007334.jpg,0,0,1,0,1,0,test
105,0506424_as-7008961.jpg,5,0,0,0,5,0,train
106,0506470_as-2612397.jpg,1,0,0,0,1,0,train
107,0506478_as-0004338.jpg,1,0,1,2,4,0,train
108,0506439_sc-185453.jpg,0,0,0,2,2,0,train
109,0506520_as-0014058.jpg,0,0,1,0,1,0,train
110,0506378_sc-198819.jpg,1,0,2,2,5,0,val
111,0506420_sc-201032.jpg,1,0,0,0,1,0,test
112,0506398_as-0067334.jpg,1,0,0,0,1,0,train
113,0506331_sc-188707.jpg,0,0,1,0,1,0,train
114,0506324_as-0001319.jpg,2,0,1,0,3,0,train
115,0506374_sc-225312.jpg,2,0,1,0,3,0,train
116,0506323_as-0001319.jpg,2,0,0,0,2,0,train
117,0506379_sc-198819.jpg,2,0,0,0,2,0,val
118,0506403_as-0067334.jpg,4,0,0,0,4,0,test
119,0506376_sc-225312.jpg,3,1,2,0,6,0,train
120,0506337_sc-193542.jpg,1,0,1,0,2,0,train
121,0506390_as-0049821.jpg,2,1,1,2,6,0,train
122,0506338_sc-193542.jpg,0,1,0,0,1,0,train
123,0506402_as-0067334.jpg,3,2,0,0,5,0,train
124,0506332_sc-188707.jpg,4,0,0,0,4,0,val
125,0506327_as-3067857.jpg,0,1,1,0,2,0,test
126,0506342_as-0088062.jpg,1,0,1,0,2,0,train
127,0506443_as-0078573.jpg,1,1,1,0,3,0,train
128,0506368_sc-194775.jpg,2,1,3,0,6,0,train
129,0506385_as-0009706.jpg,0,0,1,0,1,0,train
130,0506416_sc-201032.jpg,1,0,0,0,1,0,train
131,0506393_as-0049821.jpg,1,0,0,0,1,0,val
132,0506432_as-0015798.jpg,1,0,0,1,2,0,test
133,0506339_as-7970735.jpg,2,1,0,0,3,0,train
134,0506419_sc-201032.jpg,1,0,1,4,6,0,train
135,0506336_sc-193542.jpg,2,0,0,0,2,0,train
136,0506417_sc-201032.jpg,1,0,1,0,2,0,train
137,0506395_as-0049821.jpg,3,0,0,0,3,0,train
138,0506384_as-0009706.jpg,2,0,1,0,3,0,val
139,0506325_as-0001319.jpg,2,0,2,1,5,0,test
140,0506386_as-0009706.jpg,1,0,1,2,4,0,train
141,0506436_as-3074917.jpg,1,0,1,0,2,0,train
142,0506438_sc-185453.jpg,1,1,0,0,2,0,train
143,0506371_as-4660351.jpg,9,0,0,0,9,0,train
144,0506284_as-0034254.jpg,1,1,0,0,2,0,train
145,0506333_sc-188707.jpg,2,0,0,1,3,0,val
146,0506254_sc-124992.jpg,3,0,0,0,3,0,test
147,0506249_sc-131618.jpg,6,0,0,0,6,0,train
148,0506305_as-0052356.jpg,4,0,0,0,4,0,train
149,0506383_sc-198819.jpg,2,0,0,0,2,0,train
150,0506345_as-0040055.jpg,0,0,1,0,1,0,train
151,0506380_sc-198819.jpg,4,0,0,1,5,0,train
152,0506401_as-0067334.jpg,3,0,0,0,3,0,val
153,0506298_sc-121119.jpg,3,0,0,0,3,0,test
154,0506382_sc-198819.jpg,1,0,0,0,1,0,train
155,0506353_as-0040055.jpg,1,0,3,2,6,0,train
156,0506321_sc-1028706.jpg,2,0,0,4,6,0,train
157,0506329_as-0076827.jpg,2,0,1,1,4,0,train
158,0506381_sc-198819.jpg,2,0,0,0,2,0,train
159,0506352_as-0040055.jpg,5,1,0,0,6,0,val
160,0506344_as-0040055.jpg,5,0,0,0,5,0,test
161,0506320_sc-1028706.jpg,0,0,2,1,3,0,train
162,0506389_as-0049821.jpg,2,0,1,0,3,0,train
163,0506370_sc-1036355.jpg,1,1,0,0,2,0,train
164,0506366_as-0020965.jpg,1,0,1,0,2,0,train
165,0506334_sc-193542.jpg,2,0,1,1,4,0,train
166,0506330_sc-188707.jpg,1,0,0,1,2,0,val
167,0506377_as-2655907.jpg,1,0,2,0,3,0,test
168,0506350_as-0040055.jpg,0,2,0,2,4,0,train
169,0506400_as-0067334.jpg,5,1,0,0,6,0,train
170,0506404_sc-147276.jpg,1,0,0,1,2,0,train
171,0506354_as-0040055.jpg,4,0,0,1,5,0,train
172,0506362_sc-142205.jpg,1,0,0,0,1,0,train
173,0506373_sc-225312.jpg,0,1,0,0,1,0,val
174,0506372_sc-225312.jpg,1,1,0,0,2,0,test
175,0506359_as-0027398.jpg,0,0,1,0,1,0,train
176,0506351_as-0040055.jpg,2,0,1,1,4,0,train
177,0506340_as-0088062.jpg,0,0,1,0,1,0,train
178,0506365_as-0020965.jpg,0,0,1,2,3,0,train
179,0506361_as-0027398.jpg,2,2,1,1,6,0,train
180,0506253_sc-131618.jpg,1,0,1,0,2,0,val
181,0506295_sc-121119.jpg,0,0,0,1,1,0,test
182,0506258_sc-145679.jpg,0,0,1,0,1,0,train
183,0506304_as-0052356.jpg,4,0,0,0,4,0,train
184,0506271_sc-147905.jpg,1,0,0,0,1,0,train
185,0506300_sc-121119.jpg,0,0,2,1,3,0,train
186,0506290_sc-182108.jpg,4,0,0,0,4,0,train
187,0506317_as-3036474.jpg,2,0,1,0,3,0,val
188,0506309_sc-166817.jpg,0,2,2,0,4,0,test
189,0506346_as-0040055.jpg,3,0,0,1,4,0,train
190,0506263_sc-222093.jpg,2,1,0,0,3,0,train
191,0506367_as-0020965.jpg,3,0,0,0,3,0,train
192,0506347_as-0040055.jpg,0,1,0,0,1,0,train
193,0506315_sc-108254.jpg,1,1,0,0,2,0,train
194,0506307_as-0052356.jpg,2,0,0,0,2,0,val
195,0506387_as-0009706.jpg,3,0,0,0,3,0,test
196,0506251_sc-131618.jpg,3,0,1,0,4,0,train
197,0506256_sc-124992.jpg,4,0,1,0,5,0,train
198,0506250_sc-131618.jpg,2,0,1,1,4,0,train
199,0506349_as-0040055.jpg,1,1,0,0,2,0,train
200,0506348_as-0040055.jpg,1,1,1,0,3,0,train
201,0506301_sc-1037108.jpg,3,0,0,1,4,0,val
202,0506287_sc-109140.jpg,1,0,0,0,1,0,test
203,0506316_sc-108254.jpg,2,0,0,1,3,0,train
204,0506285_as-0034254.jpg,1,1,0,0,2,0,train
205,0506303_as-0052356.jpg,5,0,1,0,6,0,train
206,0506294_sc-121119.jpg,0,0,1,0,1,0,train
207,0506282_as-0034254.jpg,2,0,1,0,3,0,train
208,0506313_as-2983482.jpg,1,0,1,1,3,0,val
209,0506310_sc-166817.jpg,2,0,1,1,4,0,test
210,0506266_sc-227628.jpg,1,0,0,0,1,0,train
211,0506360_as-0027398.jpg,1,0,0,1,2,0,train
212,0506335_sc-193542.jpg,2,0,0,0,2,0,train
213,0506234_sc-202337.jpg,3,0,2,2,7,0,train
214,0506665_sc-224410.jpg,1,1,0,0,2,0,train
215,0506235_sc-202337.jpg,4,1,0,0,5,0,val
216,0506268_as-2719480.jpg,4,0,0,0,4,0,test
217,0506238_as-3203576.jpg,0,0,2,0,2,0,train
218,0506859_as-2539738.jpg,1,0,0,0,1,0,train
219,0506241_sc-190131.jpg,5,0,0,0,5,0,train
220,0506286_sc-109140.jpg,3,0,0,0,3,0,train
221,0506308_sc-166817.jpg,5,0,2,2,9,0,train
222,0506312_as-2802924.jpg,1,2,1,1,5,0,val
223,0506291_sc-182108.jpg,1,0,1,0,2,0,test
224,0506239_as-3483186.jpg,1,0,1,0,2,0,train
225,0506272_as-2836626.jpg,2,0,1,0,3,0,train
226,0506240_as-7962812.jpg,2,0,1,1,4,0,train
227,0506276_as-7545067.jpg,1,0,0,0,1,0,train
228,0506280_as-0034254.jpg,2,0,2,0,4,0,train
229,0506247_sc-198049.jpg,2,0,3,2,7,0,val
230,0506248_sc-221145.jpg,4,0,0,3,7,0,test
231,0506233_sc-202337.jpg,2,0,0,0,2,0,train
232,0506260_sc-1024333.jpg,8,4,2,3,17,0,train
233,0506311_sc-166817.jpg,2,0,0,0,2,0,train
234,0506288_as-2842853.jpg,0,0,1,0,1,0,train
235,0506273_sc-1006409.jpg,1,0,1,1,3,0,train
236,0506306_as-0052356.jpg,1,0,0,0,1,0,val
237,0506275_sc-1006409.jpg,4,0,0,0,4,0,test
238,0506252_sc-131618.jpg,1,0,1,0,2,0,train
239,0506279_as-0033822.jpg,2,0,1,0,3,0,train
240,0506283_as-0034254.jpg,3,2,0,0,5,0,train
241,0506292_sc-182108.jpg,2,0,0,0,2,0,train
242,0506318_sc-1011208.jpg,3,0,0,0,3,0,train
243,0506289_sc-182108.jpg,1,0,0,1,2,0,val
244,0506264_as-2700163.jpg,2,0,0,0,2,0,test
245,0506293_sc-182108.jpg,2,0,0,0,2,0,train
246,0506302_sc-1037108.jpg,1,0,0,0,1,0,train
247,0506274_sc-1006409.jpg,5,0,0,0,5,0,train
248,0506529_as-0056810.jpg,0,0,1,1,2,0,train
249,0506559_sc-1015960.jpg,1,0,1,1,3,0,train
250,0506577_as-2620439.jpg,3,0,1,0,4,0,val
251,0506661_sc-224410.jpg,4,1,1,0,6,0,test
252,0506594_sc-214054.jpg,1,0,1,0,2,0,train
253,0506551_as-7375932.jpg,4,0,0,0,4,0,train
254,0506590_sc-214054.jpg,1,0,1,0,2,0,train
255,0506563_sc-1015960.jpg,1,0,1,1,3,0,train
256,0506278_as-0017846.jpg,2,1,0,0,3,0,train
257,0506575_sc-1039844.jpg,1,0,0,0,1,0,val
258,0506610_as-0084763.jpg,1,0,1,0,2,0,test
259,0506547_as-0072206.jpg,4,1,0,0,5,0,train
260,0506532_as-2865263.jpg,7,0,0,0,7,0,train
261,0506236_sc-202337.jpg,1,0,0,0,1,0,train
262,0506561_sc-1015960.jpg,6,0,0,0,6,0,train
263,0506676_sc-1016158.jpg,3,0,0,0,3,0,train
264,0506620_sc-156338.jpg,2,0,0,0,2,0,val
265,0506524_as-0014058.jpg,2,0,1,0,3,0,test
266,0506668_sc-1038548.jpg,2,2,1,2,7,0,train
267,0506534_as-7790648.jpg,1,0,0,1,2,0,train
268,0506582_as-3109845.jpg,2,0,1,0,3,0,train
269,0506557_sc-1015960.jpg,2,0,0,0,2,0,train
270,0506560_sc-1015960.jpg,1,0,0,0,1,0,train
271,0506572_as-0074481.jpg,2,0,1,0,3,0,val
272,0506593_sc-214054.jpg,2,0,0,0,2,0,test
273,0506245_sc-198049.jpg,1,0,1,0,2,0,train
274,0506672_sc-1016158.jpg,1,1,1,0,3,0,train
275,0506599_sc-205430.jpg,3,0,0,0,3,0,train
276,0506576_sc-1039844.jpg,2,0,0,0,2,0,train
277,0506259_sc-224820.jpg,2,1,0,1,4,0,train
278,0506237_sc-202337.jpg,5,0,0,0,5,0,val
279,0506281_as-0034254.jpg,3,0,0,0,3,0,test
280,0506246_sc-198049.jpg,3,0,0,1,4,0,train
281,0506261_sc-1024333.jpg,9,0,0,0,9,0,train
282,0506585_as-0095833.jpg,5,0,0,0,5,0,train
283,0506257_sc-145679.jpg,12,1,0,0,13,0,train
284,0506262_as-9091727.jpg,2,0,0,0,2,0,train
285,0506531_sc-1018730.jpg,1,0,2,0,3,0,val
286,0506566_as-3133348.jpg,3,0,0,0,3,0,test
287,0506596_sc-214054.jpg,2,0,0,0,2,0,train
288,0506536_as-2754848.jpg,0,0,0,2,2,0,train
289,0506533_as-2929830.jpg,1,0,0,0,1,0,train
290,0506592_sc-214054.jpg,3,0,1,0,4,0,train
291,0506525_as-0040959.jpg,1,0,0,0,1,0,train
292,0506562_sc-1015960.jpg,1,0,0,0,1,0,val
293,0506537_sc-215744.jpg,1,0,0,0,1,0,test
294,0506584_as-0095833.jpg,1,0,1,1,3,0,train
295,0506579_sc-222001.jpg,9,0,0,0,9,0,train
296,0506595_sc-214054.jpg,0,0,1,0,1,0,train
297,0506555_as-2508616.jpg,2,0,0,0,2,0,train
298,0506586_as-0095833.jpg,1,0,0,0,1,0,train
299,0506569_as-0074481.jpg,4,2,4,1,11,0,val
300,0506553_as-0098773.jpg,3,0,0,0,3,0,test
301,0506527_sc-1030807.jpg,5,0,1,0,6,0,train
302,0506549_as-0072206.jpg,2,0,0,0,2,0,train
303,0506528_sc-1030807.jpg,2,0,0,0,2,0,train
304,0506581_as-2556127.jpg,1,0,0,0,1,0,train
305,0506567_as-0039478.jpg,3,1,0,0,4,0,train
306,0506571_as-0074481.jpg,2,0,0,0,2,0,val
307,0506552_as-0098773.jpg,4,0,1,0,5,0,test
308,0506578_sc-222001.jpg,0,0,1,0,1,0,train
309,0506588_as-0095833.jpg,1,0,1,0,2,0,train
310,0506543_as-0070722.jpg,1,0,1,0,2,0,train
311,0506526_as-0040959.jpg,1,0,0,0,1,0,train
312,0506591_sc-214054.jpg,1,1,2,0,4,0,train
313,0506530_sc-1018730.jpg,2,0,2,1,5,0,val
314,0506548_as-0072206.jpg,0,0,1,0,1,0,test
315,0507353_sc-116568.jpg,3,0,0,0,3,0,train
316,0507395_as-0041940.jpg,1,0,1,0,2,0,train
317,0507435_sc-194890.jpg,2,1,2,1,6,0,train
318,0507391_as-0041940.jpg,3,0,0,0,3,0,train
319,0507400_as-0070152.jpg,4,0,0,1,5,0,train
320,0507408_sc-1023808.jpg,3,3,1,0,7,0,val
321,0507349_sc-177585.jpg,2,0,0,0,2,0,test
322,0507396_sc-1032424.jpg,3,0,0,0,3,0,train
323,0507418_sc-196460.jpg,1,0,1,0,2,0,train
324,0507389_as-0041940.jpg,6,0,3,0,9,0,train
325,0507338_as-7102788.jpg,10,0,1,0,11,0,train
326,0507373_sc-201297.jpg,0,1,0,0,1,0,train
327,0507376_sc-201297.jpg,2,0,0,0,2,0,val
328,0507346_sc-151225.jpg,5,0,0,0,5,0,test
329,0507386_as-0041940.jpg,1,1,0,0,2,0,train
330,0507347_sc-145404.jpg,4,0,0,0,4,0,train
331,0507356_sc-116568.jpg,2,0,0,0,2,0,train
332,0507364_as-7412639.jpg,0,0,1,2,3,0,train
333,0507401_sc-207687.jpg,1,0,0,1,2,0,train
334,0507340_as-0037402.jpg,0,0,1,0,1,0,val
335,0507343_as-0037402.jpg,1,1,0,1,3,0,test
336,0507359_sc-131182.jpg,2,0,1,0,3,0,train
337,0507352_sc-116568.jpg,1,1,1,1,4,0,train
338,0507390_as-0041940.jpg,1,0,1,0,2,0,train
339,0507362_sc-177039.jpg,1,0,1,1,3,0,train
340,0507345_sc-151225.jpg,2,0,1,1,4,0,train
341,0507406_sc-207687.jpg,1,0,0,0,1,0,val
342,0507344_sc-151225.jpg,1,0,0,1,2,0,test
343,0507375_sc-201297.jpg,1,0,1,0,2,0,train
344,0507392_as-0041940.jpg,1,0,0,0,1,0,train
345,0507382_as-0041940.jpg,1,0,0,0,1,0,train
346,0507374_sc-201297.jpg,1,0,1,0,2,0,train
347,0507384_as-0041940.jpg,1,1,1,0,3,0,train
348,0507405_sc-207687.jpg,1,0,3,4,8,0,val
349,0507341_as-0037402.jpg,5,0,2,1,8,0,test
350,0507388_as-0041940.jpg,2,0,0,0,2,0,train
351,0507363_sc-177039.jpg,1,1,0,0,2,0,train
352,0507342_as-0037402.jpg,4,0,0,0,4,0,train
353,0507371_as-0072623.jpg,2,0,0,0,2,0,train
354,0507372_as-0072623.jpg,1,0,1,2,4,0,train
355,0507377_sc-201297.jpg,2,0,0,0,2,0,val
356,0507403_sc-207687.jpg,1,0,1,0,2,0,test
357,0507360_sc-131182.jpg,4,0,0,0,4,0,train
358,0507378_as-3358810.jpg,1,0,0,0,1,0,train
359,0507385_as-0041940.jpg,2,0,5,2,9,0,train
360,0507394_as-0041940.jpg,5,0,0,0,5,0,train
361,0507383_as-0041940.jpg,7,0,1,2,10,0,train
362,0507337_as-0018375.jpg,0,1,1,0,2,0,val
363,0507368_as-0072623.jpg,1,0,1,1,3,0,test
364,0507339_as-0037402.jpg,3,0,0,0,3,0,train
365,0507369_as-0072623.jpg,4,0,0,0,4,0,train
366,0507399_as-0070152.jpg,4,0,1,0,5,0,train
367,0507365_sc-119819.jpg,1,0,1,0,2,0,train
368,0507354_sc-116568.jpg,1,0,0,0,1,0,train
369,0507370_as-0072623.jpg,3,0,0,0,3,0,val
370,0507355_sc-116568.jpg,1,1,0,1,3,0,test
371,0507387_as-0041940.jpg,5,0,1,0,6,0,train
372,0507277_as-0014377.jpg,2,0,1,0,3,0,train
373,0507273_as-0014377.jpg,1,1,0,0,2,0,train
374,0507334_sc-183407.jpg,1,0,2,2,5,0,train
375,0507272_as-0014377.jpg,0,1,1,0,2,0,train
376,0507357_as-2761295.jpg,2,0,1,4,7,0,val
377,0507280_as-0001966.jpg,2,0,0,1,3,0,test
378,0507311_sc-119385.jpg,1,1,0,2,4,0,train
379,0507318_sc-120678.jpg,0,0,0,1,1,0,train
380,0507275_as-0014377.jpg,1,0,0,0,1,0,train
381,0507404_sc-207687.jpg,1,0,0,1,2,0,train
382,0507312_sc-119385.jpg,2,0,0,0,2,0,train
383,0507324_sc-171619.jpg,1,0,0,0,1,0,val
384,0507259_as-0068511.jpg,1,0,0,0,1,0,test
385,0507260_as-0068511.jpg,1,0,1,0,2,0,train
386,0507296_as-0093041.jpg,2,0,1,0,3,0,train
387,0507314_as-0046051.jpg,4,2,1,2,9,0,train
388,0507350_sc-220371.jpg,0,0,1,1,2,0,train
389,0507348_sc-145404.jpg,2,0,2,0,4,0,train
390,0507265_as-9021068.jpg,3,0,0,1,4,0,val
391,0507281_as-0001966.jpg,1,0,1,0,2,0,test
392,0507285_sc-210528.jpg,1,1,0,0,2,0,train
393,0507301_as-2595274.jpg,2,0,0,0,2,0,train
394,0507276_as-0014377.jpg,3,0,0,0,3,0,train
395,0507327_sc-171619.jpg,1,0,0,0,1,0,train
396,0507329_sc-171619.jpg,7,0,0,0,7,0,train
397,0507315_as-0046051.jpg,1,0,0,0,1,0,val
398,0507274_as-0014377.jpg,4,0,2,0,6,0,test
399,0507300_as-7112692.jpg,2,1,1,1,5,0,train
400,0507292_sc-210528.jpg,1,0,0,0,1,0,train
401,0507321_as-0032183.jpg,2,0,0,0,2,0,train
402,0507262_as-0061212.jpg,4,0,1,0,5,0,train
403,0507267_sc-210554.jpg,3,0,0,0,3,0,train
404,0507322_sc-171619.jpg,2,1,1,0,4,0,val
405,0507286_sc-210528.jpg,4,0,1,0,5,0,test
406,0507310_sc-119385.jpg,3,0,0,0,3,0,train
407,0507326_sc-171619.jpg,1,0,1,0,2,0,train
408,0507331_sc-171619.jpg,2,2,1,0,5,0,train
409,0507293_sc-210528.jpg,1,0,0,0,1,0,train
410,0507268_sc-210554.jpg,0,0,1,0,1,0,train
411,0507299_as-9079647.jpg,1,1,0,1,3,0,val
412,0507287_sc-210528.jpg,1,0,0,0,1,0,test
413,0507294_as-0093041.jpg,2,0,1,2,5,0,train
414,0507295_as-0093041.jpg,2,0,0,0,2,0,train
415,0507328_sc-171619.jpg,2,0,1,1,4,0,train
416,0507288_sc-210528.jpg,1,1,1,0,3,0,train
417,0507264_as-9027200.jpg,1,0,0,0,1,0,train
418,0507298_as-0093041.jpg,1,0,0,0,1,0,val
419,0507325_sc-171619.jpg,1,0,1,0,2,0,test
420,0507266_sc-210554.jpg,5,0,0,0,5,0,train
421,0507291_sc-210528.jpg,1,0,0,0,1,0,train
422,0507330_sc-171619.jpg,3,0,0,0,3,0,train
423,0507333_sc-183407.jpg,2,0,0,0,2,0,train
424,0507263_sc-169433.jpg,3,0,2,1,6,0,train
425,0507332_sc-183407.jpg,1,0,0,0,1,0,val
426,0507297_as-0093041.jpg,2,0,0,0,2,0,test
427,0507306_as-0027460.jpg,1,0,1,0,2,0,train
428,0507307_as-0027460.jpg,3,1,2,1,7,0,train
429,0507290_sc-210528.jpg,1,1,0,0,2,0,train
430,0507316_as-0046051.jpg,0,0,1,0,1,0,train
431,0507309_sc-119385.jpg,2,0,0,0,2,0,train
432,0507188_as-0012038.jpg,1,0,1,0,2,0,val
433,0507269_sc-210554.jpg,0,1,0,0,1,0,test
434,0507283_sc-210528.jpg,1,0,0,0,1,0,train
435,0507313_as-0046051.jpg,2,0,0,0,2,0,train
436,0507250_sc-127322.jpg,11,0,0,0,11,0,train
437,0507186_as-0012038.jpg,0,1,1,0,2,0,train
438,0507258_sc-119603.jpg,1,0,1,1,3,0,train
439,0507225_as-0015270.jpg,1,0,0,0,1,0,val
440,0507192_sc-157527.jpg,4,0,0,0,4,0,test
441,0507213_sc-207731.jpg,4,0,2,1,7,0,train
442,0507219_as-0061709.jpg,3,0,0,0,3,0,train
443,0507228_as-0015270.jpg,1,0,1,1,3,0,train
444,0507220_as-0008906.jpg,0,0,1,0,1,0,train
445,0507183_as-0012038.jpg,1,1,1,0,3,0,train
446,0507227_as-0015270.jpg,3,1,0,0,4,0,val
447,0507235_sc-219409.jpg,1,0,0,1,2,0,test
448,0507206_as-0053635.jpg,1,0,0,0,1,0,train
449,0507254_sc-127322.jpg,4,0,1,0,5,0,train
450,0507243_as-0080684.jpg,1,0,0,0,1,0,train
451,0507209_as-7525719.jpg,2,0,1,1,4,0,train
452,0507191_as-0012038.jpg,1,0,0,0,1,0,train
453,0507175_as-3316063.jpg,1,1,0,0,2,0,val
454,0507236_sc-219409.jpg,3,0,0,1,4,0,test
455,0507190_as-0012038.jpg,2,0,1,0,3,0,train
456,0507184_as-0012038.jpg,0,1,0,0,1,0,train
457,0507255_sc-127322.jpg,1,0,0,0,1,0,train
458,0507253_sc-127322.jpg,1,0,0,0,1,0,train
459,0507212_sc-207731.jpg,0,0,2,1,3,0,train
460,0507181_as-0020237.jpg,0,0,1,1,2,0,val
461,0507221_as-0008906.jpg,1,1,0,0,2,0,test
462,0507256_sc-127322.jpg,1,0,0,0,1,0,train
463,0507234_as-0082354.jpg,3,0,0,1,4,0,train
464,0507179_as-0020237.jpg,3,2,1,0,6,0,train
465,0507226_as-0015270.jpg,1,0,0,0,1,0,train
466,0507196_sc-221342.jpg,0,0,1,0,1,0,train
467,0507241_as-0056774.jpg,2,0,0,0,2,0,val
468,0507207_as-0053635.jpg,2,0,2,0,4,0,test
469,0507215_as-2603312.jpg,6,0,2,0,8,0,train
470,0507249_sc-127322.jpg,2,0,0,0,2,0,train
471,0507200_as-0034308.jpg,3,0,2,1,6,0,train
472,0507224_as-0015270.jpg,6,1,1,0,8,0,train
473,0507214_sc-207731.jpg,2,1,0,1,4,0,train
474,0507210_sc-207731.jpg,0,2,1,0,3,0,val
475,0507233_as-0082354.jpg,1,0,0,1,2,0,test
476,0507232_as-0082354.jpg,1,0,0,0,1,0,train
477,0507211_sc-207731.jpg,2,0,0,0,2,0,train
478,0507198_as-3120896.jpg,2,1,0,0,3,0,train
479,0507252_sc-127322.jpg,1,0,0,1,2,0,train
480,0507251_sc-127322.jpg,3,0,0,2,5,0,train
481,0507247_sc-127322.jpg,2,0,0,0,2,0,val
482,0507230_as-0015270.jpg,1,0,0,0,1,0,test
483,0507216_as-0061709.jpg,0,0,1,0,1,0,train
484,0507238_sc-219409.jpg,2,0,0,0,2,0,train
485,0507193_sc-157527.jpg,4,0,0,0,4,0,train
486,0507187_as-0012038.jpg,2,0,0,0,2,0,train
487,0507201_as-0034308.jpg,4,0,0,0,4,0,train
488,0507205_as-0053635.jpg,1,0,0,0,1,0,val
489,0507199_as-0034308.jpg,3,0,0,0,3,0,test
490,0507185_as-0012038.jpg,1,4,0,0,5,0,train
491,0507257_sc-119603.jpg,1,0,1,0,2,0,train
492,0507217_as-0061709.jpg,1,0,0,0,1,0,train
493,0507189_as-0012038.jpg,5,1,1,0,7,0,train
494,0507202_as-0034308.jpg,1,1,0,0,2,0,train
495,0507197_as-3131363.jpg,2,0,0,0,2,0,val
496,0507218_as-0061709.jpg,1,0,1,0,2,0,test
497,0507237_sc-219409.jpg,2,0,0,0,2,0,train
498,0507246_sc-127322.jpg,6,0,0,0,6,0,train
499,0507194_sc-221342.jpg,2,0,0,0,2,0,train
500,0507130_as-0012442.jpg,3,0,0,0,3,0,train
501,0507242_as-0056774.jpg,4,0,0,0,4,0,train
502,0507136_sc-1020660.jpg,1,0,0,0,1,0,val
503,0507162_as-0088944.jpg,3,0,0,0,3,0,test
504,0507169_sc-192514.jpg,1,0,4,2,7,0,train
505,0507164_sc-143197.jpg,2,0,0,0,2,0,train
506,0507112_sc-131226.jpg,2,0,0,0,2,0,train
507,0507125_sc-105354.jpg,2,0,0,1,3,0,train
508,0507109_sc-131226.jpg,1,0,0,0,1,0,train
509,0507170_sc-181661.jpg,3,0,0,0,3,0,val
510,0507195_sc-221342.jpg,2,0,0,0,2,0,test
511,0507126_as-3086522.jpg,1,1,0,1,3,0,train
512,0507111_sc-131226.jpg,0,1,0,0,1,0,train
513,0507107_as-0057881.jpg,5,0,0,0,5,0,train
514,0508104_sc-155469.jpg,2,0,0,0,2,0,train
515,0507518_as-0098013.jpg,3,0,1,0,4,0,train
516,0508086_sc-1002308.jpg,1,1,3,1,6,0,val
517,0507525_sc-125416.jpg,1,0,0,0,1,0,test
518,0507526_sc-125416.jpg,1,0,0,0,1,0,train
519,0507497_sc-179050.jpg,1,0,1,0,2,0,train
520,0507529_sc-191272.jpg,3,0,0,0,3,0,train
521,0508101_sc-155469.jpg,2,0,0,0,2,0,train
522,0508125_sc-1033015.jpg,1,0,0,0,1,0,train
523,0508119_as-0048398.jpg,1,0,0,0,1,0,val
524,0508150_as-0091038.jpg,1,0,0,0,1,0,test
525,0508142_as-0065627.jpg,1,0,0,0,1,0,train
526,0508079_sc-152419.jpg,1,2,0,0,3,0,train
527,0507494_sc-179050.jpg,1,0,0,0,1,0,train
528,0507524_sc-125416.jpg,2,0,0,0,2,0,train
529,0507514_as-0098013.jpg,0,1,0,0,1,0,train
530,0507443_as-0011294.jpg,2,0,0,0,2,0,val
531,0508129_sc-1026643.jpg,5,0,0,0,5,0,test
532,0508103_sc-155469.jpg,0,0,2,0,2,0,train
533,0508149_as-0091038.jpg,2,0,0,0,2,0,train
534,0507473_sc-1021680.jpg,1,0,3,0,4,0,train
535,0507119_as-3438913.jpg,2,0,0,0,2,0,train
536,0507174_sc-181661.jpg,3,1,0,0,4,0,train
537,0507101_sc-225891.jpg,1,0,0,1,2,0,val
538,0507159_sc-219275.jpg,2,0,0,0,2,0,test
539,0507145_as-0004572.jpg,1,0,0,0,1,0,train
540,0507137_sc-1020660.jpg,2,0,1,1,4,0,train
541,0507173_sc-181661.jpg,1,1,2,0,4,0,train
542,0507108_sc-131226.jpg,2,0,0,0,2,0,train
543,0507106_as-0057881.jpg,0,2,0,0,2,0,train
544,0507147_as-0004572.jpg,2,0,0,0,2,0,val
545,0507127_as-2555199.jpg,3,1,1,1,6,0,test
546,0507102_sc-225891.jpg,2,1,3,2,8,0,train
547,0507163_as-2822327.jpg,3,0,0,0,3,0,train
548,0507148_as-7268062.jpg,2,0,0,0,2,0,train
549,0507120_as-0023676.jpg,3,0,0,1,4,0,train
550,0507151_sc-222425.jpg,1,0,0,0,1,0,train
551,0507118_as-0030851.jpg,0,2,1,2,5,0,val
552,0507134_as-0012442.jpg,2,0,0,0,2,0,test
553,0507149_as-2855946.jpg,1,0,0,0,1,0,train
554,0507146_as-0004572.jpg,3,0,0,0,3,0,train
555,0507114_as-0029031.jpg,0,0,1,0,1,0,train
556,0507129_as-0012442.jpg,2,1,0,0,3,0,train
557,0507160_sc-219275.jpg,3,0,1,2,6,0,train
558,0507140_sc-1003335.jpg,1,0,1,0,2,0,val
559,0507171_sc-181661.jpg,9,1,4,2,16,0,test
560,0507154_as-0097944.jpg,2,1,1,1,5,0,train
561,0507133_as-0012442.jpg,2,0,1,1,4,0,train
562,0507139_sc-1003335.jpg,1,0,0,0,1,0,train
563,0507103_sc-225891.jpg,8,0,0,0,8,0,train
564,0507158_sc-219275.jpg,0,0,0,1,1,0,train
565,0507138_sc-1020660.jpg,1,0,0,0,1,0,val
566,0507135_sc-1020660.jpg,2,0,1,1,4,0,test
567,0507152_sc-115684.jpg,1,0,0,0,1,0,train
568,0507143_as-0004572.jpg,3,0,1,0,4,0,train
569,0507144_as-0004572.jpg,1,0,0,0,1,0,train
570,0507082_as-0054270.jpg,1,1,1,1,4,0,train
571,0507128_as-0012442.jpg,2,0,0,0,2,0,train
572,0507097_sc-225891.jpg,8,3,1,1,13,0,val
573,0507061_as-2547412.jpg,2,1,1,2,6,0,test
574,0507096_sc-225891.jpg,0,1,0,0,1,0,train
575,0507166_as-0044617.jpg,5,1,2,1,9,0,train
576,0507091_as-2760585.jpg,1,0,0,1,2,0,train
577,0507113_as-0029031.jpg,1,0,0,0,1,0,train
578,0507100_sc-225891.jpg,1,0,1,0,2,0,train
579,0507153_as-0097944.jpg,5,0,3,1,9,0,val
580,0507057_sc-108794.jpg,3,0,1,1,5,0,test
581,0507121_as-0085943.jpg,1,0,1,1,3,0,train
582,0507066_as-0098237.jpg,1,1,0,0,2,0,train
583,0507117_as-0030851.jpg,2,0,0,0,2,0,train
584,0507155_as-0097944.jpg,7,1,0,1,9,0,train
585,0507078_as-0054270.jpg,4,0,0,0,4,0,train
586,0507064_sc-113737.jpg,3,0,1,2,6,0,val
587,0507093_sc-225891.jpg,1,0,0,0,1,0,test
588,0507084_as-0054270.jpg,5,1,1,1,8,0,train
589,0507086_sc-102956.jpg,2,0,1,0,3,0,train
590,0507059_as-3313969.jpg,1,0,1,0,2,0,train
591,0507095_sc-225891.jpg,1,0,0,1,2,0,train
592,0507115_as-0029031.jpg,1,0,0,0,1,0,train
593,0507157_sc-219275.jpg,0,1,1,0,2,0,val
594,0507079_as-0054270.jpg,0,1,1,0,2,0,test
595,0507089_as-3477494.jpg,1,0,0,0,1,0,train
596,0507098_sc-225891.jpg,1,0,0,0,1,0,train
597,0507150_sc-222425.jpg,1,0,0,0,1,0,train
598,0507088_as-2948095.jpg,1,0,0,0,1,0,train
599,0507074_as-0098237.jpg,5,0,0,0,5,0,train
600,0507073_as-0098237.jpg,1,0,0,0,1,0,val
601,0507081_as-0054270.jpg,2,0,0,1,3,0,test
602,0507085_sc-102956.jpg,4,1,1,0,6,0,train
603,0507087_sc-102956.jpg,3,0,0,1,4,0,train
604,0507080_as-0054270.jpg,1,0,1,0,2,0,train
605,0507072_as-0098237.jpg,1,0,0,0,1,0,train
606,0507056_sc-108794.jpg,1,1,1,0,3,0,train
607,0507044_sc-1003046.jpg,2,0,0,1,3,0,val
608,0507042_sc-1003046.jpg,1,2,2,0,5,0,test
609,0507043_sc-1003046.jpg,1,1,0,0,2,0,train
610,0507055_sc-108794.jpg,1,0,0,0,1,0,train
611,0507062_sc-113737.jpg,4,0,0,0,4,0,train
612,0507050_sc-161450.jpg,1,1,0,1,3,0,train
613,0507156_sc-219275.jpg,2,0,0,0,2,0,train
614,0507058_sc-108794.jpg,3,0,1,1,5,0,val
615,0507048_sc-205837.jpg,3,0,1,0,4,0,test
616,0507099_sc-225891.jpg,1,0,0,0,1,0,train
617,0507071_as-0098237.jpg,1,0,1,0,2,0,train
618,0507053_sc-161450.jpg,2,0,0,0,2,0,train
619,0506992_sc-215700.jpg,4,0,0,0,4,0,train
620,0507011_as-0011668.jpg,2,0,4,2,8,0,train
621,0507046_sc-205837.jpg,3,0,0,0,3,0,val
622,0507094_sc-225891.jpg,2,0,3,1,6,0,test
623,0507049_sc-161450.jpg,3,1,2,0,6,0,train
624,0506967_as-0030869.jpg,1,0,1,1,3,0,train
625,0506976_as-0069378.jpg,5,0,0,0,5,0,train
626,0507090_as-7618415.jpg,2,0,0,0,2,0,train
627,0506981_sc-1020740.jpg,1,0,0,1,2,0,train
628,0507025_sc-167902.jpg,2,0,0,0,2,0,val
629,0506996_as-0038330.jpg,2,0,1,1,4,0,test
630,0507037_sc-125564.jpg,1,0,0,0,1,0,train
631,0507092_sc-225891.jpg,2,0,0,0,2,0,train
632,0507021_sc-181497.jpg,1,0,0,0,1,0,train
633,0506989_sc-215700.jpg,1,0,0,0,1,0,train
634,0506960_sc-175866.jpg,1,0,1,0,2,0,train
635,0507026_sc-167902.jpg,1,0,1,0,2,0,val
636,0506968_as-0030869.jpg,2,1,1,1,5,0,test
637,0507001_as-0038330.jpg,0,0,1,0,1,0,train
638,0507023_sc-164215.jpg,1,0,0,0,1,0,train
639,0507024_sc-164215.jpg,5,0,1,0,6,0,train
640,0506998_as-0038330.jpg,4,0,3,0,7,0,train
641,0506979_sc-161470.jpg,3,0,2,0,5,0,train
642,0507016_sc-202640.jpg,1,1,0,0,2,0,val
643,0507054_as-7513378.jpg,1,0,0,0,1,0,test
644,0507013_sc-202640.jpg,1,0,1,0,2,0,train
645,0507009_as-0011668.jpg,1,0,0,0,1,0,train
646,0507022_sc-164215.jpg,1,0,0,0,1,0,train
647,0507047_sc-205837.jpg,0,1,0,1,2,0,train
648,0507006_as-0011668.jpg,1,0,0,0,1,0,train
649,0507052_sc-161450.jpg,4,0,0,0,4,0,val
650,0507051_sc-161450.jpg,1,3,1,0,5,0,test
651,0506963_sc-1038436.jpg,1,0,0,0,1,0,train
652,0507012_as-0011668.jpg,0,0,1,0,1,0,train
653,0506966_as-0030869.jpg,5,0,0,0,5,0,train
654,0506961_as-3176631.jpg,4,0,0,0,4,0,train
655,0506959_sc-175866.jpg,1,0,0,0,1,0,train
656,0507031_as-7483844.jpg,3,0,0,1,4,0,val
657,0507474_as-2837617.jpg,1,0,1,1,3,0,test
658,0506991_sc-215700.jpg,2,0,0,0,2,0,train
659,0506984_sc-1021418.jpg,0,0,1,0,1,0,train
660,0508114_as-3497309.jpg,1,0,0,0,1,0,train
661,0508152_as-0091038.jpg,10,0,2,1,13,0,train
662,0507035_as-0018518.jpg,3,0,1,0,4,0,train
663,0507429_sc-181541.jpg,5,1,0,0,6,0,val
664,0506990_sc-215700.jpg,1,1,0,0,2,0,test
665,0507019_as-0035190.jpg,1,0,1,1,3,0,train
666,0506970_as-0001486.jpg,0,1,1,0,2,0,train
667,0507451_as-0046949.jpg,2,0,0,2,4,0,train
668,0508136_as-0057740.jpg,1,0,0,0,1,0,train
669,0507002_as-0038330.jpg,1,0,0,0,1,0,train
670,0508151_as-0091038.jpg,2,0,0,0,2,0,val
671,0508082_sc-152419.jpg,5,0,0,0,5,0,test
672,0507036_as-0018518.jpg,1,0,0,0,1,0,train
673,0506956_sc-175866.jpg,2,0,0,0,2,0,train
674,0506982_sc-1020740.jpg,1,1,1,1,4,0,train
675,0506962_sc-1038436.jpg,1,0,0,0,1,0,train
676,0507459_sc-151779.jpg,8,0,0,0,8,0,train
677,0507431_as-3128259.jpg,1,0,0,0,1,0,val
678,0507468_as-7373159.jpg,2,0,1,0,3,0,test
679,0507469_sc-116500.jpg,3,0,0,0,3,0,train
680,0508097_as-3082408.jpg,1,1,0,1,3,0,train
681,0508088_as-3034253.jpg,1,0,1,1,3,0,train
682,0507039_sc-1017999.jpg,1,0,0,0,1,0,train
683,0508074_as-0036677.jpg,1,0,0,0,1,0,train
684,0507028_as-0036522.jpg,1,0,0,0,1,0,val
685,0507445_as-0046949.jpg,2,0,0,0,2,0,test
686,0507432_as-3314287.jpg,3,0,0,1,4,0,train
687,0508090_as-0022625.jpg,1,0,0,0,1,0,train
688,0508073_as-0036677.jpg,1,0,1,0,2,0,train
689,0507040_sc-1003046.jpg,1,0,0,0,1,0,train
690,0508120_as-0048398.jpg,3,1,1,0,5,0,train
691,0508102_sc-155469.jpg,8,0,0,0,8,0,val
692,0507004_as-0038330.jpg,4,0,0,0,4,0,test
693,0506969_as-0001486.jpg,2,0,0,0,2,0,train
694,0507420_sc-1040741.jpg,3,0,0,0,3,0,train
695,0506985_as-2601681.jpg,1,0,1,0,2,0,train
696,0508076_as-0036677.jpg,1,0,0,0,1,0,train
697,0506958_sc-175866.jpg,2,0,0,1,3,0,train
698,0506977_as-0069378.jpg,1,1,0,0,2,0,val
699,0506837_sc-157608.jpg,2,2,3,0,7,0,test
700,0506834_as-7254572.jpg,1,0,1,2,4,0,train
701,0506813_sc-145547.jpg,3,1,1,1,6,0,train
702,0506823_as-0049604.jpg,1,0,1,0,2,0,train
703,0506864_sc-1014354.jpg,5,0,0,0,5,0,train
704,0506818_as-0049604.jpg,1,1,1,0,3,0,train
705,0506811_sc-1022938.jpg,8,0,0,0,8,0,val
706,0506848_as-0031154.jpg,3,0,0,0,3,0,test
707,0506822_as-0049604.jpg,0,1,1,0,2,0,train
708,0506863_as-0064582.jpg,2,0,0,0,2,0,train
709,0506858_as-3032887.jpg,2,1,0,0,3,0,train
710,0506855_sc-213030.jpg,1,0,0,0,1,0,train
711,0506845_as-3442508.jpg,1,0,0,0,1,0,train
712,0506849_as-0031154.jpg,2,0,1,1,4,0,val
713,0506814_sc-145547.jpg,1,1,0,1,3,0,test
714,0506856_sc-213030.jpg,2,0,1,0,3,0,train
715,0506846_as-2643929.jpg,2,0,0,0,2,0,train
716,0506815_sc-104631.jpg,2,0,0,0,2,0,train
717,0506826_as-0049604.jpg,3,1,0,0,4,0,train
718,0506843_sc-129609.jpg,1,0,1,0,2,0,train
719,0506819_as-0049604.jpg,1,0,0,0,1,0,val
720,0506867_as-3313834.jpg,5,1,1,1,8,0,test
721,0506810_as-9013373.jpg,2,0,0,1,3,0,train
722,0506838_sc-157608.jpg,1,0,0,0,1,0,train
723,0506758_as-0055624.jpg,1,0,1,0,2,0,train
724,0506835_as-3437606.jpg,1,0,0,1,2,0,train
725,0506832_sc-1022391.jpg,1,0,0,0,1,0,train
726,0506759_as-0055624.jpg,1,0,0,0,1,0,val
727,0506821_as-0049604.jpg,1,1,1,1,4,0,test
728,0506868_sc-111961.jpg,3,0,0,0,3,0,train
729,0506761_as-0055624.jpg,0,0,0,1,1,0,train
730,0506807_sc-193597.jpg,1,0,0,0,1,0,train
731,0506854_sc-213030.jpg,2,0,2,1,5,0,train
732,0506786_sc-193868.jpg,1,0,0,0,1,0,train
733,0506752_sc-223960.jpg,0,0,2,1,3,0,val
734,0506770_as-0065857.jpg,3,1,2,1,7,0,test
735,0506775_as-0065857.jpg,1,0,3,0,4,0,train
736,0506865_sc-1014354.jpg,0,0,0,1,1,0,train
737,0506760_as-0055624.jpg,0,3,1,1,5,0,train
738,0506745_as-0066257.jpg,1,0,0,0,1,0,train
739,0506772_as-0065857.jpg,1,0,1,0,2,0,train
740,0506753_sc-223960.jpg,1,0,0,0,1,0,val
741,0506842_sc-157608.jpg,3,0,0,0,3,0,test
742,0506816_sc-104631.jpg,0,1,0,0,1,0,train
743,0506769_as-0065857.jpg,2,0,0,0,2,0,train
744,0506798_as-3424738.jpg,2,0,0,1,3,0,train
745,0506806_sc-193597.jpg,2,2,2,0,6,0,train
746,0506740_as-0066257.jpg,2,0,1,0,3,0,train
747,0506748_sc-201177.jpg,2,2,3,2,9,0,val
748,0506771_as-0065857.jpg,1,0,0,0,1,0,test
749,0506802_sc-205765.jpg,1,0,0,0,1,0,train
750,0506744_as-0066257.jpg,2,0,0,1,3,0,train
751,0506805_sc-193597.jpg,2,0,0,1,3,0,train
752,0506784_as-9039802.jpg,4,0,1,0,5,0,train
753,0506754_sc-223960.jpg,3,0,2,1,6,0,train
754,0506857_as-0049006.jpg,0,0,0,1,1,0,val
755,0506783_as-0084692.jpg,1,0,0,1,2,0,test
756,0506776_as-3126906.jpg,1,0,0,0,1,0,train
757,0506751_sc-223960.jpg,5,1,0,1,7,0,train
758,0506801_sc-205765.jpg,1,0,1,0,2,0,train
759,0506790_as-0032904.jpg,0,0,0,2,2,0,train
760,0506747_sc-201177.jpg,1,0,0,1,2,0,train
761,0506765_sc-162829.jpg,6,0,0,0,6,0,val
762,0506809_as-2817789.jpg,1,0,0,0,1,0,test
763,0506766_sc-162829.jpg,2,0,1,0,3,0,train
764,0506796_sc-196222.jpg,4,1,1,0,6,0,train
765,0506757_as-0055624.jpg,1,0,0,0,1,0,train
766,0506794_sc-196222.jpg,1,1,1,0,3,0,train
767,0506764_as-3386001.jpg,1,0,0,0,1,0,train
768,0506763_as-3386001.jpg,1,0,1,1,3,0,val
769,0508153_as-0091038.jpg,0,0,0,1,1,0,test
770,0506800_sc-205765.jpg,4,0,0,0,4,0,train
771,0508110_sc-155469.jpg,2,0,0,1,3,0,train
772,0506788_as-0032904.jpg,3,0,0,0,3,0,train
773,0506739_as-0066257.jpg,2,0,0,0,2,0,train
774,0506799_sc-205765.jpg,1,0,0,1,2,0,train
775,0506785_as-3070840.jpg,3,0,0,0,3,0,val
776,0506746_sc-201177.jpg,1,0,0,0,1,0,test
777,0506749_sc-201177.jpg,2,0,0,0,2,0,train
778,0506789_as-0032904.jpg,0,0,1,0,1,0,train
779,0506787_as-3356715.jpg,1,0,0,0,1,0,train
780,0506980_sc-161470.jpg,5,0,0,0,5,0,train
781,0506792_as-3056158.jpg,2,0,0,0,2,0,train
782,0506750_sc-201177.jpg,4,2,2,0,8,0,val
783,0506782_as-0084692.jpg,3,0,0,0,3,0,test
784,0508138_sc-1035185.jpg,1,1,1,0,3,0,train
785,0506762_as-3307539.jpg,1,0,0,0,1,0,train
786,0508143_sc-1024471.jpg,2,0,0,0,2,0,train
787,0506706_as-0083030.jpg,1,0,1,0,2,0,train
788,0507033_as-0018518.jpg,1,1,1,0,3,0,train
789,0507010_as-0011668.jpg,1,0,1,1,3,0,val
790,0508094_as-2661246.jpg,1,0,0,0,1,0,test
791,0508081_sc-152419.jpg,1,0,0,0,1,0,train
792,0506957_sc-175866.jpg,0,1,0,0,1,0,train
793,0507007_as-0011668.jpg,2,0,0,0,2,0,train
794,0508105_sc-155469.jpg,0,0,0,1,1,0,train
795,0506695_sc-104147.jpg,3,1,1,0,5,0,train
796,0506680_sc-185412.jpg,3,0,0,0,3,0,val
797,0507014_sc-202640.jpg,3,0,0,0,3,0,test
798,0506999_as-0038330.jpg,0,0,1,0,1,0,train
799,0506686_as-0044756.jpg,3,0,1,0,4,0,train
800,0506755_as-7723773.jpg,5,0,1,0,6,0,train
801,0506688_sc-192385.jpg,2,1,1,2,6,0,train
802,0506726_as-0030259.jpg,1,0,0,0,1,0,train
803,0506986_sc-1035998.jpg,2,0,1,1,4,0,val
804,0507003_as-0038330.jpg,1,0,0,1,2,0,test
805,0506717_sc-126782.jpg,2,0,1,0,3,0,train
806,0506781_as-0084692.jpg,2,0,0,1,3,0,train
807,0506712_as-0083030.jpg,0,1,0,0,1,0,train
808,0507034_as-0018518.jpg,1,0,0,0,1,0,train
809,0506974_sc-209670.jpg,1,0,0,0,1,0,train
810,0506704_sc-158709.jpg,1,0,0,0,1,0,val
811,0507020_as-0035190.jpg,5,0,3,1,9,0,test
812,0506714_as-0083030.jpg,3,0,0,0,3,0,train
813,0506978_as-0069378.jpg,1,0,0,1,2,0,train
814,0507000_as-0038330.jpg,0,0,0,1,1,0,train
815,0506685_as-0044756.jpg,5,1,0,0,6,0,train
816,0506727_as-0030259.jpg,1,1,0,0,2,0,train
817,0506987_sc-1035998.jpg,6,0,0,0,6,0,val
818,0506683_sc-198155.jpg,0,1,0,0,1,0,test
819,0506690_sc-104147.jpg,3,0,0,1,4,0,train
820,0507008_as-0011668.jpg,1,0,0,0,1,0,train
821,0506732_as-0083086.jpg,3,0,0,0,3,0,train
822,0507032_as-0018518.jpg,0,1,1,1,3,0,train
823,0506723_as-0030259.jpg,3,1,0,0,4,0,train
824,0507015_sc-202640.jpg,5,0,1,2,8,0,val
825,0506997_as-0038330.jpg,2,1,0,0,3,0,test
826,0506707_as-0083030.jpg,3,0,0,0,3,0,train
827,0506699_as-0033012.jpg,1,0,1,0,2,0,train
828,0506696_sc-130374.jpg,5,0,1,0,6,0,train
829,0506681_as-2608556.jpg,7,0,0,0,7,0,train
830,0506975_as-0069378.jpg,1,0,0,0,1,0,train
831,0506903_sc-226409.jpg,1,0,0,0,1,0,val
832,0506687_sc-192385.jpg,0,0,1,0,1,0,test
833,0506724_as-0030259.jpg,2,0,2,0,4,0,train
834,0506941_sc-1015806.jpg,2,0,0,0,2,0,train
835,0507027_as-0036522.jpg,2,0,1,1,4,0,train
836,0506915_sc-144371.jpg,2,0,0,1,3,0,train
837,0506697_sc-130374.jpg,1,0,0,0,1,0,train
838,0506943_as-9011591.jpg,0,0,1,0,1,0,val
839,0506870_as-0063304.jpg,1,0,0,0,1,0,test
840,0506884_as-0021699.jpg,1,0,0,1,2,0,train
841,0506909_sc-1035602.jpg,1,0,0,0,1,0,train
842,0506904_as-0037132.jpg,1,0,0,1,2,0,train
843,0506709_as-0083030.jpg,0,2,1,0,3,0,train
844,0507018_as-0035190.jpg,2,0,0,2,4,0,train
845,0506689_sc-104147.jpg,5,1,0,0,6,0,val
846,0506679_sc-185412.jpg,1,0,0,0,1,0,test
847,0506710_as-0083030.jpg,1,0,0,1,2,0,train
848,0506908_as-0037132.jpg,2,0,1,1,4,0,train
849,0506952_sc-185760.jpg,6,0,0,1,7,0,train
850,0506719_as-0028348.jpg,0,1,0,0,1,0,train
851,0506682_sc-198155.jpg,1,0,2,0,3,0,train
852,0506713_as-0083030.jpg,1,0,0,0,1,0,val
853,0506896_as-2923369.jpg,0,1,0,0,1,0,test
854,0506735_as-3118816.jpg,1,0,0,0,1,0,train
855,0506705_as-2767913.jpg,5,1,1,0,7,0,train
856,0506716_sc-126782.jpg,2,0,0,0,2,0,train
857,0506721_as-0035117.jpg,1,0,2,1,4,0,train
858,0506729_sc-1004947.jpg,7,0,1,1,9,0,train
859,0506886_sc-1024054.jpg,5,0,0,0,5,0,val
860,0506703_sc-158709.jpg,2,0,0,0,2,0,test
861,0506983_sc-1020740.jpg,3,0,3,0,6,0,train
862,0506711_as-0083030.jpg,2,0,0,0,2,0,train
863,0506919_sc-144371.jpg,1,0,0,1,2,0,train
864,0506907_as-0037132.jpg,0,0,3,0,3,0,train
865,0506910_as-0027365.jpg,0,0,1,0,1,0,train
866,0506901_as-7344758.jpg,1,0,1,1,3,0,val
867,0506940_sc-1039950.jpg,3,1,1,0,5,0,test
868,0506730_sc-1004947.jpg,5,2,0,1,8,0,train
869,0506698_sc-156261.jpg,1,1,0,0,2,0,train
870,0506954_sc-185760.jpg,2,0,0,0,2,0,train
871,0506693_sc-104147.jpg,1,0,1,1,3,0,train
872,0506720_as-0029856.jpg,1,1,1,1,4,0,train
873,0506725_as-0030259.jpg,1,0,0,0,1,0,val
874,0506922_as-0078111.jpg,0,0,1,0,1,0,test
875,0506946_as-0078065.jpg,2,0,1,1,4,0,train
876,0506691_sc-104147.jpg,5,0,0,0,5,0,train
877,0506734_as-2820984.jpg,2,0,0,1,3,0,train
878,0506932_as-0020240.jpg,0,0,2,0,2,0,train
879,0506654_as-0048299.jpg,5,0,1,0,6,0,train
880,0506733_as-0083086.jpg,1,0,0,0,1,0,val
881,0506873_as-0013004.jpg,2,0,1,0,3,0,test
882,0506936_sc-1039950.jpg,1,0,0,0,1,0,train
883,0506905_as-0037132.jpg,2,0,0,0,2,0,train
884,0506893_as-0034411.jpg,2,0,0,0,2,0,train
885,0506926_as-0085223.jpg,2,0,0,0,2,0,train
886,0506666_sc-224410.jpg,0,1,0,0,1,0,train
887,0506881_as-0021699.jpg,2,0,1,1,4,0,val
888,0506674_sc-1016158.jpg,2,1,1,0,4,0,test
889,0506659_as-2749988.jpg,1,0,2,0,3,0,train
890,0506895_as-0034411.jpg,1,0,0,0,1,0,train
891,0506664_sc-224410.jpg,0,0,0,1,1,0,train
892,0506650_as-0048299.jpg,1,0,0,0,1,0,train
893,0506702_sc-158709.jpg,1,0,0,0,1,0,train
894,0506942_as-3471430.jpg,1,0,0,0,1,0,val
895,0506694_sc-104147.jpg,0,1,1,0,2,0,test
896,0506894_as-0034411.jpg,1,0,0,0,1,0,train
897,0506917_sc-144371.jpg,1,0,0,0,1,0,train
898,0506621_sc-156338.jpg,3,0,0,0,3,0,train
899,0506601_sc-227195.jpg,4,1,1,1,7,0,train
900,0506625_sc-113646.jpg,0,2,0,0,2,0,train
901,0506673_sc-1016158.jpg,1,0,0,0,1,0,val
902,0506663_sc-224410.jpg,2,0,0,1,3,0,test
903,0506877_sc-206219.jpg,3,1,1,1,6,0,train
904,0506640_sc-166048.jpg,1,0,1,1,3,0,train
905,0506906_as-0037132.jpg,3,0,1,0,4,0,train
906,0506634_sc-118329.jpg,1,0,0,0,1,0,train
907,0506923_as-0078111.jpg,7,1,1,1,10,0,train
908,0506930_as-0020240.jpg,1,0,0,0,1,0,val
909,0506916_sc-144371.jpg,1,0,0,0,1,0,test
910,0506660_sc-224410.jpg,1,0,1,0,2,0,train
911,0506636_as-3274455.jpg,1,0,0,0,1,0,train
912,0506603_as-0084763.jpg,5,0,1,1,7,0,train
913,0506652_as-0048299.jpg,1,0,1,2,4,0,train
914,0506887_sc-1024054.jpg,2,0,0,1,3,0,train
915,0506927_as-0085223.jpg,1,0,2,0,3,0,val
916,0506619_as-3118136.jpg,1,0,0,0,1,0,test
917,0506602_as-2550252.jpg,4,0,0,0,4,0,train
918,0506888_as-9089332.jpg,3,1,1,0,5,0,train
919,0506885_as-2740740.jpg,0,0,1,0,1,0,train
920,0506880_as-0021699.jpg,2,0,1,0,3,0,train
921,0506648_sc-213708.jpg,2,0,1,0,3,0,train
922,0506879_as-0021699.jpg,2,0,0,0,2,0,val
923,0506890_as-3011553.jpg,1,0,0,1,2,0,test
924,0506630_sc-113646.jpg,1,0,0,2,3,0,train
925,0506671_sc-1016158.jpg,0,1,2,0,3,0,train
926,0506929_as-0085223.jpg,1,0,0,0,1,0,train
927,0506920_sc-144371.jpg,4,0,1,0,5,0,train
928,0506608_as-0084763.jpg,2,0,0,0,2,0,train
929,0506921_as-0078111.jpg,1,1,1,0,3,0,val
930,0506613_sc-226931.jpg,4,0,0,0,4,0,test
931,0506949_as-0078065.jpg,2,0,0,0,2,0,train
932,0506937_sc-1039950.jpg,2,0,0,0,2,0,train
933,0506624_sc-113646.jpg,1,0,0,0,1,0,train
934,0506612_sc-226931.jpg,6,0,1,1,8,0,train
935,0506626_sc-113646.jpg,1,0,0,0,1,0,train
936,0506913_as-0027365.jpg,2,0,0,0,2,0,val
937,0506882_as-0021699.jpg,1,0,1,0,2,0,test
938,0506914_as-3467234.jpg,1,0,0,0,1,0,train
939,0506604_as-0084763.jpg,3,1,0,0,4,0,train
940,0506953_sc-185760.jpg,7,0,1,0,8,0,train
941,0506657_sc-221057.jpg,2,0,0,0,2,0,train
942,0506945_as-0078065.jpg,0,0,1,0,1,0,train
943,0506609_as-0084763.jpg,0,1,0,0,1,0,val
944,0506939_sc-1039950.jpg,0,1,0,1,2,0,test
945,0506911_as-0027365.jpg,1,0,0,1,2,0,train
946,0506670_sc-1016158.jpg,2,0,1,1,4,0,train
947,0506647_sc-213708.jpg,1,0,0,0,1,0,train
948,0506891_as-0034411.jpg,1,0,0,3,4,0,train
949,0506638_sc-166048.jpg,2,0,0,2,4,0,train
950,0506876_as-0013004.jpg,1,0,0,0,1,0,val
951,0506875_as-0013004.jpg,4,0,1,1,6,0,test
952,0506655_as-0048299.jpg,1,0,0,0,1,0,train
953,0506669_sc-1038548.jpg,1,0,0,0,1,0,train
954,0506874_as-0013004.jpg,2,0,0,0,2,0,train
955,0506675_sc-1016158.jpg,3,0,0,0,3,0,train
956,0506651_as-0048299.jpg,1,0,0,0,1,0,train
957,0506948_as-0078065.jpg,1,0,0,0,1,0,val
958,0506615_sc-213526.jpg,3,0,0,0,3,0,test
959,0506633_sc-118329.jpg,0,1,0,0,1,0,train
960,0506631_sc-118329.jpg,5,0,1,1,7,0,train
961,0506933_as-0020240.jpg,1,0,0,0,1,0,train
962,0506617_as-3248130.jpg,1,0,0,0,1,0,train
963,0506872_as-0063304.jpg,0,1,1,0,2,0,train
964,0506629_sc-113646.jpg,2,0,0,1,3,0,val
965,0506653_as-0048299.jpg,2,0,1,0,3,0,test
966,0506892_as-0034411.jpg,0,0,2,0,2,0,train
967,0506950_as-0078065.jpg,6,0,1,0,7,0,train
968,0506649_sc-190600.jpg,0,0,3,0,3,0,train
969,0506635_sc-118329.jpg,0,1,0,0,1,0,train
970,0506883_as-0021699.jpg,1,0,0,0,1,0,train
971,0506853_sc-213030.jpg,0,0,1,0,1,0,val
972,0506944_as-0045534.jpg,0,0,1,1,2,0,test
973,0506928_as-0085223.jpg,11,0,0,0,11,0,train
974,0506955_as-3129111.jpg,1,0,0,0,1,0,train
975,0506646_sc-213708.jpg,1,0,2,1,4,0,train
976,0506912_as-0027365.jpg,1,0,0,0,1,0,train
977,0506871_as-0063304.jpg,4,0,0,0,4,0,train
978,0506606_as-0084763.jpg,1,0,0,0,1,0,val
979,0506918_sc-144371.jpg,0,0,1,1,2,0,test
980,0506639_sc-166048.jpg,2,0,0,0,2,0,train
981,0506637_sc-166048.jpg,1,0,3,1,5,0,train
982,0506645_as-0076066.jpg,1,1,0,0,2,0,train
983,0506830_sc-192326.jpg,5,0,1,2,8,0,train
984,0506623_sc-156338.jpg,1,1,0,0,2,0,train
985,0506662_sc-224410.jpg,1,0,1,0,2,0,val
986,0506573_sc-1000981.jpg,3,0,0,1,4,0,test
987,0506817_sc-104631.jpg,0,1,0,0,1,0,train
988,0506622_sc-156338.jpg,4,1,1,0,6,0,train
989,0506618_as-2920252.jpg,4,0,0,0,4,0,train
990,0506667_sc-224410.jpg,2,0,0,1,3,0,train
991,0506829_sc-192326.jpg,1,0,0,0,1,0,train
992,0506545_as-0070722.jpg,8,0,0,0,8,0,val
993,0506656_as-0048299.jpg,1,0,0,0,1,0,test
994,0506866_sc-1014354.jpg,7,1,0,0,8,0,train
995,0506840_sc-157608.jpg,6,0,0,0,6,0,train
996,0506898_as-0035777.jpg,1,0,1,0,2,0,train
997,0506541_as-3272509.jpg,4,0,0,0,4,0,train
998,0506934_as-0020240.jpg,2,0,0,0,2,0,train
999,0506598_sc-205430.jpg,1,0,2,1,4,0,val
1000,0507804_sc-153240.jpg,3,0,0,2,5,0,test
1001,0507434_sc-194890.jpg,1,0,0,0,1,0,train
1002,0508713_as-0010865.jpg,2,0,0,0,2,0,train
1003,0507282_sc-210528.jpg,1,0,0,0,1,0,train
1004,0508130_sc-1026643.jpg,1,0,0,1,2,0,train
1005,0507284_sc-210528.jpg,1,0,0,0,1,0,train
1006,0508733_sc-172158.jpg,0,1,0,0,1,0,val
1007,0507402_sc-207687.jpg,1,0,1,2,4,0,test
1008,0508728_as-0056219.jpg,2,2,0,0,4,0,train
1009,0508720_sc-104852.jpg,1,1,2,0,4,0,train
1010,0508725_sc-210056.jpg,2,1,1,0,4,0,train
1011,0508736_as-0048908.jpg,4,0,0,0,4,0,train
1012,0508739_as-0018374.jpg,1,0,0,1,2,0,train
1013,0507289_sc-210528.jpg,3,0,0,0,3,0,val
1014,0508740_as-0018374.jpg,1,0,0,1,2,0,test
1015,0507907_as-0040857.jpg,2,0,0,0,2,0,train
1016,0508710_as-0010865.jpg,0,0,1,0,1,0,train
1017,0508703_sc-175070.jpg,2,0,1,0,3,0,train
1018,0508705_sc-175070.jpg,2,1,1,1,5,0,train
1019,0508741_as-0018374.jpg,1,0,0,0,1,0,train
1020,0506570_as-0074481.jpg,0,1,0,0,1,0,val
1021,0508734_as-0048908.jpg,2,0,0,0,2,0,test
1022,0508743_as-0061375.jpg,1,0,0,1,2,0,train
1023,0508708_as-0010865.jpg,1,0,0,0,1,0,train
1024,0508738_as-0048908.jpg,1,0,0,0,1,0,train
1025,0508729_as-0001947.jpg,1,0,1,0,2,0,train
1026,0508744_as-0061375.jpg,1,0,0,0,1,0,train
1027,0508665_sc-186084.jpg,2,0,0,0,2,0,val
1028,0508730_as-0001947.jpg,1,0,0,0,1,0,test
1029,0508722_sc-210056.jpg,1,0,1,0,2,0,train
1030,0508701_sc-117704.jpg,2,0,0,0,2,0,train
1031,0508727_as-0056219.jpg,0,0,0,1,1,0,train
1032,0508704_sc-175070.jpg,4,0,0,0,4,0,train
1033,0508709_as-0010865.jpg,2,0,1,0,3,0,train
1034,0508706_sc-175070.jpg,1,0,0,0,1,0,val
1035,0508711_as-0010865.jpg,1,2,1,0,4,0,test
1036,0508731_sc-172158.jpg,4,0,0,0,4,0,train
1037,0508745_as-0061375.jpg,1,0,0,0,1,0,train
1038,0508737_as-0048908.jpg,1,0,1,1,3,0,train
1039,0508690_sc-145033.jpg,0,0,1,0,1,0,train
1040,0508631_as-0085637.jpg,5,0,0,0,5,0,train
1041,0508735_as-0048908.jpg,6,1,0,1,8,0,val
1042,0508732_sc-172158.jpg,1,0,1,0,2,0,test
1043,0508723_sc-210056.jpg,1,0,0,0,1,0,train
1044,0508693_as-0074766.jpg,4,0,0,0,4,0,train
1045,0508717_sc-104852.jpg,1,0,0,0,1,0,train
1046,0508638_sc-1007311.jpg,1,0,0,1,2,0,train
1047,0508633_sc-136679.jpg,2,0,1,1,4,0,train
1048,0508666_sc-186084.jpg,1,0,0,1,2,0,val
1049,0508682_as-0064788.jpg,8,0,0,0,8,0,test
1050,0508668_sc-135942.jpg,1,1,0,0,2,0,train
1051,0508674_sc-164811.jpg,1,0,0,0,1,0,train
1052,0508667_sc-186084.jpg,1,0,0,0,1,0,train
1053,0508672_sc-135942.jpg,3,0,0,0,3,0,train
1054,0508685_as-0064788.jpg,2,0,1,2,5,0,train
1055,0508632_as-2802631.jpg,0,1,1,1,3,0,val
1056,0508656_sc-197280.jpg,4,1,0,1,6,0,test
1057,0508679_as-0064788.jpg,1,0,0,0,1,0,train
1058,0508673_as-7657588.jpg,1,0,0,0,1,0,train
1059,0508654_as-3447153.jpg,2,0,0,0,2,0,train
1060,0508648_sc-150343.jpg,4,1,2,2,9,0,train
1061,0508694_as-3382746.jpg,0,0,1,0,1,0,train
1062,0508637_sc-121212.jpg,1,0,0,0,1,0,val
1063,0508639_sc-1007311.jpg,1,0,0,1,2,0,test
1064,0508630_as-0008521.jpg,0,0,1,0,1,0,train
1065,0508689_sc-145033.jpg,1,2,0,0,3,0,train
1066,0508651_sc-107520.jpg,1,0,0,0,1,0,train
1067,0508660_as-0026676.jpg,1,0,0,0,1,0,train
1068,0508653_as-2857477.jpg,1,0,1,0,2,0,train
1069,0508677_sc-164811.jpg,1,0,1,0,2,0,val
1070,0508696_sc-159346.jpg,3,0,0,0,3,0,test
1071,0508640_sc-1007311.jpg,3,2,0,1,6,0,train
1072,0508675_sc-164811.jpg,4,0,1,0,5,0,train
1073,0508697_as-2887306.jpg,1,0,0,0,1,0,train
1074,0508676_sc-164811.jpg,5,0,1,0,6,0,train
1075,0508657_sc-197280.jpg,1,0,0,0,1,0,train
1076,0508642_as-0094221.jpg,1,0,0,2,3,0,val
1077,0508688_sc-145033.jpg,1,0,0,0,1,0,test
1078,0508634_sc-136679.jpg,1,0,0,1,2,0,train
1079,0508699_as-0044548.jpg,1,0,0,0,1,0,train
1080,0508643_as-0094221.jpg,4,0,0,0,4,0,train
1081,0508681_as-0064788.jpg,2,0,2,0,4,0,train
1082,0508650_as-2816697.jpg,2,1,0,0,3,0,train
1083,0508687_sc-145033.jpg,1,0,0,0,1,0,val
1084,0508683_as-0064788.jpg,4,0,0,0,4,0,test
1085,0508655_sc-197280.jpg,1,0,0,0,1,0,train
1086,0508698_as-0044548.jpg,4,0,0,0,4,0,train
1087,0508700_as-0044548.jpg,2,0,1,0,3,0,train
1088,0508670_sc-135942.jpg,2,0,0,0,2,0,train
1089,0508671_sc-135942.jpg,2,3,0,0,5,0,train
1090,0508659_as-0026676.jpg,0,1,1,0,2,0,val
1091,0508652_sc-107520.jpg,2,0,0,0,2,0,test
1092,0508635_as-2700982.jpg,5,0,0,0,5,0,train
1093,0508571_as-0040498.jpg,3,0,0,0,3,0,train
1094,0508616_sc-220540.jpg,1,0,1,0,2,0,train
1095,0508623_sc-105543.jpg,2,0,0,0,2,0,train
1096,0508692_sc-145033.jpg,1,2,0,0,3,0,train
1097,0508582_sc-191171.jpg,1,0,0,0,1,0,val
1098,0508579_sc-191171.jpg,2,0,0,0,2,0,test
1099,0508590_sc-108800.jpg,5,0,0,0,5,0,train
1100,0508587_sc-1036160.jpg,1,0,0,1,2,0,train
1101,0508628_as-0008521.jpg,3,1,1,2,7,0,train
1102,0508619_sc-105543.jpg,2,0,0,1,3,0,train
1103,0508569_sc-119000.jpg,2,0,0,0,2,0,train
1104,0508595_as-9092452.jpg,1,0,0,0,1,0,val
1105,0508580_sc-191171.jpg,1,0,0,0,1,0,test
1106,0508626_sc-105364.jpg,7,0,2,2,11,0,train
1107,0508594_sc-108800.jpg,1,0,0,0,1,0,train
1108,0508606_sc-1000752.jpg,1,0,4,0,5,0,train
1109,0508620_sc-105543.jpg,2,1,0,1,4,0,train
1110,0508597_as-0096215.jpg,1,1,0,0,2,0,train
1111,0508568_sc-119000.jpg,0,0,1,0,1,0,val
1112,0508611_as-3463135.jpg,1,0,0,0,1,0,test
1113,0508617_sc-220540.jpg,3,2,2,0,7,0,train
1114,0508573_as-0040498.jpg,2,1,3,1,7,0,train
1115,0508588_sc-1036160.jpg,1,0,0,0,1,0,train
1116,0508589_sc-1036160.jpg,1,1,0,0,2,0,train
1117,0508622_sc-105543.jpg,4,0,0,1,5,0,train
1118,0508618_as-7203231.jpg,0,0,0,1,1,0,val
1119,0508585_sc-218712.jpg,3,1,2,0,6,0,test
1120,0508624_sc-105364.jpg,2,0,0,0,2,0,train
1121,0508586_sc-1036160.jpg,2,0,0,1,3,0,train
1122,0508609_as-0078091.jpg,1,0,0,0,1,0,train
1123,0508576_as-2714244.jpg,2,0,0,0,2,0,train
1124,0508614_sc-191963.jpg,2,0,0,0,2,0,train
1125,0508608_as-0078091.jpg,0,0,1,0,1,0,val
1126,0508604_as-7995112.jpg,1,0,1,1,3,0,test
1127,0508591_sc-108800.jpg,1,0,0,1,2,0,train
1128,0508607_sc-1000752.jpg,1,1,0,0,2,0,train
1129,0508577_as-3436422.jpg,1,0,0,1,2,0,train
1130,0508605_sc-1000752.jpg,0,0,0,1,1,0,train
1131,0508593_sc-108800.jpg,3,0,0,0,3,0,train
1132,0508574_as-0040498.jpg,1,1,1,0,3,0,val
1133,0508625_sc-105364.jpg,1,1,0,0,2,0,test
1134,0508541_as-0066779.jpg,9,0,0,3,12,0,train
1135,0508575_as-0040498.jpg,5,0,1,0,6,0,train
1136,0508600_as-0096215.jpg,1,1,1,0,3,0,train
1137,0508544_as-0006709.jpg,2,0,0,0,2,0,train
1138,0508535_sc-220180.jpg,2,0,0,0,2,0,train
1139,0508603_as-3280129.jpg,1,0,0,2,3,0,val
1140,0508583_sc-194262.jpg,3,0,0,0,3,0,test
1141,0508536_sc-220180.jpg,2,0,0,0,2,0,train
1142,0508534_sc-220180.jpg,4,0,1,1,6,0,train
1143,0508584_as-0092695.jpg,3,0,0,0,3,0,train
1144,0508566_as-0052807.jpg,1,0,0,1,2,0,train
1145,0508596_as-7584562.jpg,1,0,0,0,1,0,train
1146,0508520_as-0057380.jpg,2,1,0,0,3,0,val
1147,0508572_as-0040498.jpg,0,1,2,0,3,0,test
1148,0508621_sc-105543.jpg,8,1,0,1,10,0,train
1149,0508531_sc-228240.jpg,4,0,0,1,5,0,train
1150,0508565_as-0052807.jpg,2,1,0,0,3,0,train
1151,0508578_sc-229048.jpg,0,0,2,0,2,0,train
1152,0508398_as-0034744.jpg,0,0,1,0,1,0,train
1153,0508354_as-0039084.jpg,1,0,0,0,1,0,val
1154,0508361_sc-133015.jpg,7,0,0,0,7,0,test
1155,0508352_as-0039084.jpg,4,0,0,1,5,0,train
1156,0508396_as-0034744.jpg,4,0,0,0,4,0,train
1157,0508404_sc-104358.jpg,0,1,0,0,1,0,train
1158,0508382_as-2680476.jpg,2,0,1,0,3,0,train
1159,0508421_sc-125437.jpg,0,0,1,0,1,0,train
1160,0508349_as-0039084.jpg,1,2,0,0,3,0,val
1161,0508419_sc-125437.jpg,2,0,1,0,3,0,test
1162,0508391_sc-1040921.jpg,1,0,0,1,2,0,train
1163,0508390_sc-1040921.jpg,2,0,0,0,2,0,train
1164,0508378_as-0041703.jpg,3,0,0,0,3,0,train
1165,0508362_sc-133015.jpg,2,0,0,0,2,0,train
1166,0508364_as-0068746.jpg,3,0,0,0,3,0,train
1167,0508368_as-7655491.jpg,0,1,0,0,1,0,val
1168,0508387_as-0071893.jpg,2,1,2,1,6,0,test
1169,0508424_sc-125437.jpg,0,1,1,1,3,0,train
1170,0508369_sc-216267.jpg,4,0,0,1,5,0,train
1171,0508411_sc-104358.jpg,7,0,0,0,7,0,train
1172,0508386_as-0071893.jpg,6,0,0,0,6,0,train
1173,0508359_sc-208301.jpg,1,0,0,0,1,0,train
1174,0508397_as-0034744.jpg,1,0,0,0,1,0,val
1175,0508366_as-0068746.jpg,5,0,1,1,7,0,test
1176,0508423_sc-125437.jpg,2,0,1,0,3,0,train
1177,0508418_sc-125437.jpg,4,0,1,0,5,0,train
1178,0508399_sc-157478.jpg,1,0,0,0,1,0,train
1179,0508395_as-0009864.jpg,1,0,0,0,1,0,train
1180,0508351_as-0039084.jpg,3,0,1,0,4,0,train
1181,0508357_as-0039084.jpg,2,0,0,1,3,0,val
1182,0508417_as-3370933.jpg,1,0,0,0,1,0,test
1183,0508360_sc-133015.jpg,1,0,0,2,3,0,train
1184,0508373_sc-195120.jpg,1,0,0,0,1,0,train
1185,0508355_as-0039084.jpg,2,0,0,0,2,0,train
1186,0508381_sc-195570.jpg,1,0,0,0,1,0,train
1187,0508413_as-2988300.jpg,1,0,0,0,1,0,train
1188,0508367_as-2727869.jpg,1,0,0,0,1,0,val
1189,0508414_as-2988300.jpg,1,0,0,1,2,0,test
1190,0508385_as-0071893.jpg,2,1,0,1,4,0,train
1191,0508416_sc-219360.jpg,2,2,0,0,4,0,train
1192,0508358_as-9033091.jpg,3,0,1,2,6,0,train
1193,0508420_sc-125437.jpg,1,1,0,0,2,0,train
1194,0508422_sc-125437.jpg,1,0,1,1,3,0,train
1195,0508353_as-0039084.jpg,1,0,0,0,1,0,val
1196,0508377_as-2950843.jpg,5,0,2,0,7,0,test
1197,0508372_sc-125264.jpg,1,0,0,0,1,0,train
1198,0508347_as-3303949.jpg,1,0,0,1,2,0,train
1199,0508356_as-0039084.jpg,1,1,0,0,2,0,train
1200,0508401_sc-104358.jpg,0,1,0,0,1,0,train
1201,0508523_sc-144510.jpg,5,0,0,0,5,0,train
1202,0508403_sc-104358.jpg,2,0,0,0,2,0,val
1203,0508547_as-0080366.jpg,1,0,0,0,1,0,test
1204,0508402_sc-104358.jpg,2,0,0,0,2,0,train
1205,0508407_sc-104358.jpg,3,0,1,0,4,0,train
1206,0508557_sc-191891.jpg,1,0,0,0,1,0,train
1207,0508542_as-0006709.jpg,6,1,0,0,7,0,train
1208,0508370_sc-216267.jpg,0,1,0,0,1,0,train
1209,0508553_sc-191891.jpg,3,0,0,0,3,0,val
1210,0508527_sc-1035882.jpg,6,0,0,0,6,0,test
1211,0508394_as-0009864.jpg,3,1,1,1,6,0,train
1212,0508532_sc-220180.jpg,2,0,0,0,2,0,train
1213,0508383_as-2680713.jpg,0,1,0,0,1,0,train
1214,0508365_as-0068746.jpg,3,1,0,0,4,0,train
1215,0508389_sc-111363.jpg,1,0,1,0,2,0,train
1216,0508521_as-0057380.jpg,2,0,1,0,3,0,val
1217,0508406_sc-104358.jpg,3,0,0,0,3,0,test
1218,0508545_as-3080802.jpg,2,2,0,0,4,0,train
1219,0508552_sc-1019590.jpg,1,0,0,0,1,0,train
1220,0508306_sc-150209.jpg,2,0,0,0,2,0,train
1221,0508543_as-0006709.jpg,0,0,2,0,2,0,train
1222,0508350_as-0039084.jpg,6,0,0,0,6,0,train
1223,0508344_sc-1024003.jpg,1,0,0,0,1,0,val
1224,0508363_sc-133015.jpg,1,0,0,0,1,0,test
1225,0508538_as-2657476.jpg,1,0,0,1,2,0,train
1226,0508561_as-3205828.jpg,5,0,0,0,5,0,train
1227,0508283_sc-149865.jpg,6,0,1,1,8,0,train
1228,0508524_as-7973154.jpg,0,0,0,1,1,0,train
1229,0508559_as-3000711.jpg,2,0,1,4,7,0,train
1230,0508554_sc-191891.jpg,6,1,2,1,10,0,val
1231,0508546_as-2528486.jpg,1,0,1,2,4,0,test
1232,0508277_as-0072917.jpg,3,0,1,3,7,0,train
1233,0508522_as-0057380.jpg,1,0,0,0,1,0,train
1234,0508345_sc-1024003.jpg,1,0,0,0,1,0,train
1235,0508280_sc-103827.jpg,2,0,0,0,2,0,train
1236,0508562_as-3258636.jpg,4,0,0,0,4,0,train
1237,0508320_sc-130483.jpg,1,0,0,0,1,0,val
1238,0508533_sc-220180.jpg,1,1,0,0,2,0,test
1239,0508335_as-3487890.jpg,1,0,0,0,1,0,train
1240,0508286_sc-149865.jpg,1,0,0,0,1,0,train
1241,0508314_as-2813344.jpg,3,1,0,0,4,0,train
1242,0508327_sc-1009833.jpg,4,0,0,0,4,0,train
1243,0508537_sc-220180.jpg,1,0,0,0,1,0,train
1244,0508525_as-2911171.jpg,3,0,0,0,3,0,val
1245,0508321_sc-130483.jpg,0,0,0,1,1,0,test
1246,0508530_as-0058642.jpg,1,0,0,0,1,0,train
1247,0508312_as-0036960.jpg,1,0,1,1,3,0,train
1248,0508551_sc-1019590.jpg,1,0,0,1,2,0,train
1249,0508558_sc-191891.jpg,1,0,0,1,2,0,train
1250,0508330_as-2705990.jpg,1,0,0,0,1,0,train
1251,0508325_sc-1009833.jpg,2,0,0,1,3,0,val
1252,0508502_as-0078585.jpg,1,0,0,0,1,0,test
1253,0508278_as-0072917.jpg,2,1,0,0,3,0,train
1254,0508555_sc-191891.jpg,4,0,0,0,4,0,train
1255,0508303_as-2823111.jpg,4,0,1,0,5,0,train
1256,0508299_sc-168196.jpg,1,0,0,1,2,0,train
1257,0508500_sc-195928.jpg,2,0,0,0,2,0,train
1258,0508343_as-0008202.jpg,3,0,0,0,3,0,val
1259,0508482_as-0050053.jpg,1,1,0,0,2,0,test
1260,0508342_as-0008202.jpg,0,0,1,0,1,0,train
1261,0508459_sc-1013701.jpg,3,1,0,0,4,0,train
1262,0508281_sc-103827.jpg,1,1,1,0,3,0,train
1263,0508304_as-2823111.jpg,2,0,0,0,2,0,train
1264,0508318_sc-130483.jpg,0,1,0,0,1,0,train
1265,0508429_sc-213082.jpg,2,0,0,0,2,0,val
1266,0508297_as-0078362.jpg,4,0,0,1,5,0,test
1267,0508334_as-0045089.jpg,1,0,0,0,1,0,train
1268,0508447_sc-116793.jpg,3,0,0,0,3,0,train
1269,0508489_as-0004639.jpg,4,0,0,0,4,0,train
1270,0508509_sc-165404.jpg,1,0,0,0,1,0,train
1271,0508279_as-0072917.jpg,2,1,4,1,8,0,train
1272,0508503_sc-176211.jpg,1,0,0,1,2,0,val
1273,0508460_sc-1030080.jpg,0,0,1,1,2,0,test
1274,0508475_sc-165516.jpg,0,1,0,0,1,0,train
1275,0508435_as-0017854.jpg,9,0,1,0,10,0,train
1276,0508513_sc-165404.jpg,1,0,0,0,1,0,train
1277,0508317_sc-130483.jpg,1,0,0,0,1,0,train
1278,0508298_as-0073130.jpg,1,0,0,0,1,0,train
1279,0508341_as-0008202.jpg,4,0,1,0,5,0,val
1280,0508507_as-0075890.jpg,0,0,2,1,3,0,test
1281,0508333_as-0045089.jpg,2,0,1,0,3,0,train
1282,0508486_sc-1001125.jpg,1,0,0,0,1,0,train
1283,0508301_sc-1025887.jpg,4,0,2,1,7,0,train
1284,0508316_sc-130483.jpg,4,0,0,0,4,0,train
1285,0508498_sc-195928.jpg,2,0,0,1,3,0,train
1286,0508462_sc-1030080.jpg,1,0,0,1,2,0,val
1287,0508287_sc-1031554.jpg,1,0,1,2,4,0,test
1288,0508338_as-0070891.jpg,5,0,1,0,6,0,train
1289,0508326_sc-1009833.jpg,1,1,0,0,2,0,train
1290,0508445_as-0017854.jpg,1,0,1,0,2,0,train
1291,0508288_sc-1031554.jpg,2,0,0,0,2,0,train
1292,0508485_sc-1001125.jpg,1,0,1,0,2,0,train
1293,0508506_as-0075890.jpg,3,0,0,1,4,0,val
1294,0508295_as-0078362.jpg,1,0,2,2,5,0,test
1295,0508310_as-0036960.jpg,0,0,2,0,2,0,train
1296,0508296_as-0078362.jpg,2,0,0,0,2,0,train
1297,0508474_sc-165516.jpg,1,0,0,0,1,0,train
1298,0508307_sc-150209.jpg,3,0,0,0,3,0,train
1299,0508458_sc-1013701.jpg,1,0,0,0,1,0,train
1300,0508340_as-0070891.jpg,4,0,0,0,4,0,val
1301,0508495_sc-195928.jpg,1,0,0,0,1,0,test
1302,0508328_as-0047197.jpg,1,0,0,0,1,0,train
1303,0508319_sc-130483.jpg,3,1,1,0,5,0,train
1304,0508514_sc-165404.jpg,0,1,1,0,2,0,train
1305,0508311_as-0036960.jpg,1,0,0,1,2,0,train
1306,0508438_as-0017854.jpg,1,0,0,0,1,0,train
1307,0508426_as-0070253.jpg,1,0,1,0,2,0,val
1308,0508346_sc-1024003.jpg,3,0,0,0,3,0,test
1309,0508465_sc-185337.jpg,0,1,0,1,2,0,train
1310,0508470_sc-165516.jpg,1,0,0,0,1,0,train
1311,0508457_sc-1013701.jpg,3,0,2,1,6,0,train
1312,0508292_sc-1031554.jpg,2,0,0,0,2,0,train
1313,0508282_sc-149865.jpg,0,0,1,0,1,0,train
1314,0508305_sc-150209.jpg,2,0,0,1,3,0,val
1315,0508461_sc-1030080.jpg,1,0,0,1,2,0,test
1316,0508464_sc-1030080.jpg,1,0,1,0,2,0,train
1317,0508490_as-0004639.jpg,0,1,0,1,2,0,train
1318,0508517_sc-116358.jpg,0,3,2,2,7,0,train
1319,0508294_as-0078362.jpg,3,2,0,0,5,0,train
1320,0508444_as-0017854.jpg,2,0,0,0,2,0,train
1321,0508488_as-0004639.jpg,1,0,0,0,1,0,val
1322,0508313_as-2813344.jpg,0,0,0,1,1,0,test
1323,0508284_sc-149865.jpg,1,0,0,1,2,0,train
1324,0508499_sc-195928.jpg,2,0,0,0,2,0,train
1325,0508339_as-0070891.jpg,1,0,0,1,2,0,train
1326,0508493_as-0004639.jpg,2,2,1,0,5,0,train
1327,0508473_sc-165516.jpg,1,0,0,0,1,0,train
1328,0508230_as-0038959.jpg,1,0,0,1,2,0,val
1329,0508484_as-9052575.jpg,2,0,1,1,4,0,test
1330,0508259_sc-1014719.jpg,1,0,0,0,1,0,train
1331,0508434_as-0017854.jpg,1,1,1,2,5,0,train
1332,0508238_as-9074483.jpg,1,0,0,0,1,0,train
1333,0508471_sc-165516.jpg,1,0,0,0,1,0,train
1334,0508253_sc-154874.jpg,1,1,0,3,5,0,train
1335,0508308_sc-150209.jpg,0,0,1,1,2,0,val
1336,0508270_as-7003521.jpg,1,0,2,1,4,0,test
1337,0508491_as-0004639.jpg,1,0,1,0,2,0,train
1338,0508246_sc-195256.jpg,2,0,0,0,2,0,train
1339,0508481_as-0050053.jpg,2,0,1,0,3,0,train
1340,0508428_as-0070253.jpg,3,0,1,0,4,0,train
1341,0508254_sc-154874.jpg,0,1,0,0,1,0,train
1342,0508268_as-0057616.jpg,2,0,0,1,3,0,val
1343,0508264_as-0057616.jpg,0,0,0,1,1,0,test
1344,0508463_sc-1030080.jpg,3,0,1,0,4,0,train
1345,0508427_as-0070253.jpg,8,0,0,1,9,0,train
1346,0508260_sc-1014719.jpg,4,0,1,0,5,0,train
1347,0508324_sc-1009833.jpg,1,0,0,1,2,0,train
1348,0508472_sc-165516.jpg,1,0,0,0,1,0,train
1349,0508516_sc-116358.jpg,1,0,0,0,1,0,val
1350,0508274_sc-159694.jpg,1,0,1,1,3,0,test
1351,0508494_as-3136789.jpg,2,0,0,0,2,0,train
1352,0508237_as-7351110.jpg,1,0,0,1,2,0,train
1353,0508266_as-0057616.jpg,6,0,0,0,6,0,train
1354,0508466_sc-185337.jpg,1,1,1,1,4,0,train
1355,0508478_as-2679221.jpg,1,0,0,0,1,0,train
1356,0508440_as-0017854.jpg,3,0,0,0,3,0,val
1357,0508229_as-0038959.jpg,0,2,2,2,6,0,test
1358,0508232_as-0038959.jpg,1,0,2,1,4,0,train
1359,0508510_sc-165404.jpg,9,0,0,0,9,0,train
1360,0508240_as-0030864.jpg,1,0,0,0,1,0,train
1361,0508269_as-0071706.jpg,2,0,0,0,2,0,train
1362,0508267_as-0057616.jpg,4,1,1,0,6,0,train
1363,0508454_as-0024871.jpg,3,2,1,0,6,0,val
1364,0508487_as-0004639.jpg,0,0,1,0,1,0,test
1365,0508515_sc-116358.jpg,7,0,1,1,9,0,train
1366,0508512_sc-165404.jpg,1,0,0,0,1,0,train
1367,0508258_as-0079539.jpg,2,1,0,1,4,0,train
1368,0508337_as-0070891.jpg,3,0,0,0,3,0,train
1369,0508492_as-0004639.jpg,1,0,0,0,1,0,train
1370,0508241_as-2746979.jpg,1,0,0,1,2,0,val
1371,0508236_sc-140457.jpg,6,0,3,2,11,0,test
1372,0508504_sc-176211.jpg,1,0,0,0,1,0,train
1373,0508629_as-0008521.jpg,3,0,0,0,3,0,train
1374,0508443_as-0017854.jpg,0,1,0,0,1,0,train
1375,0508483_as-2882941.jpg,4,0,1,0,5,0,train
1376,0508477_sc-165516.jpg,1,0,0,0,1,0,train
1377,0508271_sc-159694.jpg,1,0,2,0,3,0,val
1378,0508249_as-2578688.jpg,2,0,1,0,3,0,test
1379,0508251_as-7986004.jpg,2,0,0,0,2,0,train
1380,0508273_sc-159694.jpg,0,1,2,0,3,0,train
1381,0508255_sc-197462.jpg,0,0,0,1,1,0,train
1382,0508467_sc-185337.jpg,1,1,0,0,2,0,train
1383,0508455_as-0024871.jpg,0,1,1,0,2,0,train
1384,0508468_sc-185337.jpg,1,0,0,0,1,0,val
1385,0508242_sc-118386.jpg,1,0,1,1,3,0,test
1386,0508261_as-3439527.jpg,2,0,1,0,3,0,train
1387,0508437_as-0017854.jpg,2,0,0,0,2,0,train
1388,0508227_as-0038959.jpg,0,1,1,0,2,0,train
1389,0508231_as-0038959.jpg,2,0,0,0,2,0,train
1390,0508476_sc-165516.jpg,1,2,1,0,4,0,train
1391,0508263_as-0057616.jpg,1,0,1,1,3,0,val
1392,0508479_as-2643086.jpg,3,0,0,0,3,0,test
1393,0508441_as-0017854.jpg,4,0,0,0,4,0,train
1394,0508265_as-0057616.jpg,1,0,0,0,1,0,train
1395,0508228_as-0038959.jpg,2,0,1,3,6,0,train
1396,0508380_as-0001286.jpg,2,0,0,0,2,0,train
1397,0508272_sc-159694.jpg,0,1,1,1,3,0,train
1398,0508239_sc-169857.jpg,1,0,0,1,2,0,val
1399,0508247_sc-195256.jpg,1,0,0,0,1,0,test
1400,0508248_sc-195256.jpg,4,2,1,1,8,0,train
1401,0508415_as-7923356.jpg,1,0,0,0,1,0,train
1402,0508234_as-2917729.jpg,1,0,0,0,1,0,train
1403,0508243_sc-118386.jpg,2,0,1,0,3,0,train
1404,0508244_sc-118386.jpg,1,1,0,0,2,0,train
1405,0508235_as-2729452.jpg,4,0,1,1,6,0,val
1406,0508250_as-3415654.jpg,2,0,1,1,4,0,test
1407,0508216_sc-1013406.jpg,3,0,0,0,3,0,train
1408,0508184_sc-107666.jpg,1,1,2,0,4,0,train
1409,0508107_sc-155469.jpg,3,0,0,2,5,0,train
1410,0508139_as-0065627.jpg,1,0,0,0,1,0,train
1411,0508123_sc-1033015.jpg,2,0,0,0,2,0,train
1412,0508141_as-0065627.jpg,4,0,0,0,4,0,val
1413,0508117_as-2688869.jpg,2,0,0,0,2,0,test
1414,0508109_sc-155469.jpg,1,0,0,0,1,0,train
1415,0508131_sc-207267.jpg,1,0,1,2,4,0,train
1416,0508092_as-0022625.jpg,1,0,0,0,1,0,train
1417,0508100_sc-155469.jpg,1,0,0,0,1,0,train
1418,0508078_as-0045763.jpg,2,1,2,1,6,0,train
1419,0508093_as-0022625.jpg,2,1,2,0,5,0,val
1420,0508132_as-0057740.jpg,2,0,0,0,2,0,test
1421,0508115_as-3161396.jpg,1,0,0,0,1,0,train
1422,0508077_as-0045763.jpg,2,0,0,0,2,0,train
1423,0508168_as-0059219.jpg,1,0,2,0,3,0,train
1424,0508075_as-0036677.jpg,6,0,1,1,8,0,train
1425,0508108_sc-155469.jpg,0,1,0,0,1,0,train
1426,0508096_sc-199341.jpg,1,0,4,1,6,0,val
1427,0508147_as-0032649.jpg,4,3,2,0,9,0,test
1428,0508085_sc-143953.jpg,2,0,0,0,2,0,train
1429,0508126_sc-1033015.jpg,1,0,0,0,1,0,train
1430,0508113_sc-155469.jpg,2,0,0,0,2,0,train
1431,0508135_as-0057740.jpg,1,0,0,0,1,0,train
1432,0508057_as-3239105.jpg,1,1,1,0,3,0,train
1433,0508087_sc-1002308.jpg,1,0,0,0,1,0,val
1434,0508080_sc-152419.jpg,4,0,1,0,5,0,test
1435,0508030_sc-1022741.jpg,2,0,0,0,2,0,train
1436,0508012_as-0086818.jpg,1,0,1,1,3,0,train
1437,0508021_sc-187412.jpg,1,0,0,0,1,0,train
1438,0508133_as-0057740.jpg,2,0,0,0,2,0,train
1439,0508124_sc-1033015.jpg,1,0,0,0,1,0,train
1440,0508010_as-0086818.jpg,1,0,1,0,2,0,val
1441,0508060_as-0052151.jpg,1,1,0,1,3,0,test
1442,0508017_sc-196624.jpg,1,0,1,1,3,0,train
1443,0508145_as-0032649.jpg,0,0,0,1,1,0,train
1444,0508091_as-0022625.jpg,3,0,1,1,5,0,train
1445,0508028_as-7221675.jpg,1,0,1,0,2,0,train
1446,0508106_sc-155469.jpg,2,0,0,0,2,0,train
1447,0508046_sc-1036311.jpg,5,0,2,0,7,0,val
1448,0508043_sc-195478.jpg,1,0,1,0,2,0,test
1449,0508146_as-0032649.jpg,4,2,2,1,9,0,train
1450,0508127_as-0018845.jpg,2,0,0,1,3,0,train
1451,0508045_sc-1036311.jpg,2,0,0,0,2,0,train
1452,0508112_sc-155469.jpg,2,0,1,0,3,0,train
1453,0508111_sc-155469.jpg,1,0,1,0,2,0,train
1454,0508050_as-0018795.jpg,1,0,0,0,1,0,val
1455,0508064_sc-206823.jpg,0,1,0,0,1,0,test
1456,0507995_as-0057693.jpg,1,0,0,0,1,0,train
1457,0508056_as-0018795.jpg,2,0,0,1,3,0,train
1458,0508039_sc-1037905.jpg,2,0,0,0,2,0,train
1459,0508071_as-0036677.jpg,1,0,1,0,2,0,train
1460,0507993_as-0057693.jpg,2,2,1,0,5,0,train
1461,0508038_sc-1037905.jpg,1,0,0,0,1,0,val
1462,0508036_sc-1037905.jpg,3,0,0,0,3,0,test
1463,0508003_sc-230125.jpg,1,0,0,0,1,0,train
1464,0508002_sc-230125.jpg,0,0,1,0,1,0,train
1465,0507997_sc-230125.jpg,1,1,0,0,2,0,train
1466,0508061_as-2999967.jpg,0,0,1,0,1,0,train
1467,0508042_sc-195478.jpg,0,0,1,0,1,0,train
1468,0508013_as-0086818.jpg,1,0,0,0,1,0,val
1469,0507999_sc-230125.jpg,1,0,0,0,1,0,test
1470,0508000_sc-230125.jpg,3,0,0,0,3,0,train
1471,0508066_sc-206823.jpg,1,0,0,0,1,0,train
1472,0508031_sc-1022741.jpg,2,0,0,0,2,0,train
1473,0507998_sc-230125.jpg,8,0,0,0,8,0,train
1474,0508033_sc-124485.jpg,2,0,0,0,2,0,train
1475,0508009_as-0086818.jpg,1,0,1,0,2,0,val
1476,0508051_as-0018795.jpg,1,0,3,1,5,0,test
1477,0508005_as-0045523.jpg,2,0,0,1,3,0,train
1478,0508063_sc-206823.jpg,2,1,0,1,4,0,train
1479,0508068_sc-206823.jpg,2,1,3,1,7,0,train
1480,0508016_sc-196624.jpg,1,0,0,0,1,0,train
1481,0508067_sc-206823.jpg,1,0,0,0,1,0,train
1482,0508006_as-0045523.jpg,2,0,0,0,2,0,val
1483,0508053_as-0018795.jpg,1,0,0,0,1,0,test
1484,0508004_as-0045523.jpg,1,0,0,1,2,0,train
1485,0508065_sc-206823.jpg,1,1,0,1,3,0,train
1486,0508069_sc-206823.jpg,1,1,1,1,4,0,train
1487,0508034_sc-124485.jpg,1,0,1,1,3,0,train
1488,0508019_sc-187412.jpg,2,0,0,0,2,0,train
1489,0508055_as-0018795.jpg,2,0,0,0,2,0,val
1490,0508054_as-0018795.jpg,1,0,0,1,2,0,test
1491,0507996_sc-230125.jpg,2,1,1,1,5,0,train
1492,0508052_as-0018795.jpg,1,1,1,1,4,0,train
1493,0508070_as-0036677.jpg,3,0,0,1,4,0,train
1494,0508049_as-0018795.jpg,1,0,0,0,1,0,train
1495,0508018_sc-196624.jpg,2,0,0,0,2,0,train
1496,0508023_sc-187412.jpg,2,2,3,1,8,0,val
1497,0508041_sc-195478.jpg,2,0,0,0,2,0,test
1498,0507969_sc-211221.jpg,2,0,0,0,2,0,train
1499,0508047_sc-1036311.jpg,1,0,0,0,1,0,train
1500,0508022_sc-187412.jpg,1,0,1,0,2,0,train
1501,0507978_as-0012711.jpg,4,0,0,0,4,0,train
1502,0507983_as-0012711.jpg,1,0,1,0,2,0,train
1503,0507935_as-0051594.jpg,0,1,0,0,1,0,val
1504,0507991_as-0012711.jpg,2,1,0,1,4,0,test
1505,0508037_sc-1037905.jpg,0,1,0,0,1,0,train
1506,0507976_as-0012711.jpg,10,0,0,0,10,0,train
1507,0507990_as-0012711.jpg,1,0,0,0,1,0,train
1508,0507994_as-0057693.jpg,0,0,1,1,2,0,train
1509,0507964_as-0070786.jpg,2,0,0,0,2,0,train
1510,0508001_sc-230125.jpg,1,0,0,0,1,0,val
1511,0507989_as-0012711.jpg,1,0,1,1,3,0,test
1512,0507960_sc-153318.jpg,1,0,0,0,1,0,train
1513,0507981_as-0012711.jpg,1,1,0,0,2,0,train
1514,0507986_as-0012711.jpg,3,0,0,0,3,0,train
1515,0507939_as-2868317.jpg,3,0,0,0,3,0,train
1516,0508032_sc-124485.jpg,1,0,0,0,1,0,train
1517,0507934_as-0051594.jpg,1,1,0,0,2,0,val
1518,0507948_as-0075007.jpg,1,0,0,0,1,0,test
1519,0507947_as-0075007.jpg,0,2,0,0,2,0,train
1520,0508035_sc-1037905.jpg,1,0,1,3,5,0,train
1521,0507987_as-0012711.jpg,1,0,0,0,1,0,train
1522,0507951_as-0075007.jpg,1,0,0,0,1,0,train
1523,0507931_as-2675705.jpg,3,0,0,0,3,0,train
1524,0507985_as-0012711.jpg,3,0,0,1,4,0,val
1525,0508025_sc-180747.jpg,3,0,1,0,4,0,test
1526,0507980_as-0012711.jpg,1,1,0,1,3,0,train
1527,0507954_as-0053714.jpg,1,0,0,0,1,0,train
1528,0507975_as-0012711.jpg,2,0,1,1,4,0,train
1529,0507938_sc-1033533.jpg,2,0,0,0,2,0,train
1530,0507979_as-0012711.jpg,0,1,2,0,3,0,train
1531,0507956_sc-1018280.jpg,11,1,2,0,14,0,val
1532,0507952_as-3400234.jpg,3,0,1,3,7,0,test
1533,0507984_as-0012711.jpg,2,1,0,0,3,0,train
1534,0507966_as-2695683.jpg,0,1,0,0,1,0,train
1535,0507944_as-0075007.jpg,5,1,2,0,8,0,train
1536,0507946_as-0075007.jpg,0,1,0,1,2,0,train
1537,0507959_sc-153318.jpg,1,0,0,0,1,0,train
1538,0507933_as-0004347.jpg,3,0,0,0,3,0,val
1539,0507903_as-0040857.jpg,1,0,1,1,3,0,test
1540,0507920_as-3390682.jpg,4,1,0,0,5,0,train
1541,0507940_sc-122573.jpg,1,0,0,1,2,0,train
1542,0507967_sc-211221.jpg,2,0,1,0,3,0,train
1543,0507932_as-7268442.jpg,2,0,0,0,2,0,train
1544,0507988_as-0012711.jpg,4,0,1,1,6,0,train
1545,0507977_as-0012711.jpg,2,0,1,0,3,0,val
1546,0507949_as-0075007.jpg,2,0,0,0,2,0,test
1547,0507955_as-0053714.jpg,3,0,0,0,3,0,train
1548,0507942_as-0075007.jpg,0,0,0,1,1,0,train
1549,0507982_as-0012711.jpg,4,0,1,0,5,0,train
1550,0507973_sc-117452.jpg,1,2,0,0,3,0,train
1551,0507950_as-0075007.jpg,0,1,0,0,1,0,train
1552,0507965_as-0070786.jpg,1,0,1,0,2,0,val
1553,0507970_sc-147643.jpg,6,0,0,0,6,0,test
1554,0507958_as-2683295.jpg,1,0,0,0,1,0,train
1555,0507923_as-2993594.jpg,1,0,0,0,1,0,train
1556,0507905_as-0040857.jpg,2,0,0,0,2,0,train
1557,0507936_sc-1033533.jpg,1,0,0,0,1,0,train
1558,0507930_sc-133088.jpg,2,0,0,0,2,0,train
1559,0507929_as-0027917.jpg,3,0,2,1,6,0,val
1560,0507968_sc-211221.jpg,2,0,3,1,6,0,test
1561,0507906_as-0040857.jpg,1,2,2,0,5,0,train
1562,0507961_sc-153318.jpg,3,0,0,0,3,0,train
1563,0507910_as-0031587.jpg,3,0,0,1,4,0,train
1564,0507913_as-0031587.jpg,1,1,0,1,3,0,train
1565,0507919_as-0018473.jpg,1,1,1,1,4,0,train
1566,0507898_as-0042631.jpg,3,0,0,0,3,0,val
1567,0507962_sc-153318.jpg,2,0,1,1,4,0,test
1568,0507911_as-0031587.jpg,2,2,0,0,4,0,train
1569,0507922_sc-196709.jpg,0,1,0,0,1,0,train
1570,0507904_as-0040857.jpg,2,0,0,0,2,0,train
1571,0507943_as-0075007.jpg,3,0,1,1,5,0,train
1572,0507914_as-0076119.jpg,6,0,1,0,7,0,train
1573,0507915_as-0018473.jpg,0,0,2,0,2,0,val
1574,0507912_as-0031587.jpg,8,0,0,0,8,0,test
1575,0507921_sc-196709.jpg,0,1,2,0,3,0,train
1576,0507918_as-0018473.jpg,0,1,1,0,2,0,train
1577,0507882_as-0031052.jpg,2,0,0,1,3,0,train
1578,0507825_sc-106887.jpg,3,1,0,1,5,0,train
1579,0507875_as-2923865.jpg,0,1,1,0,2,0,train
1580,0507924_as-0027917.jpg,1,0,1,1,3,0,val
1581,0507863_as-0062125.jpg,2,1,0,0,3,0,test
1582,0507819_as-0026471.jpg,2,0,1,2,5,0,train
1583,0507803_sc-153240.jpg,1,2,1,1,5,0,train
1584,0507826_sc-106887.jpg,2,0,1,3,6,0,train
1585,0507866_as-0011702.jpg,2,0,0,0,2,0,train
1586,0507812_sc-190525.jpg,1,0,0,1,2,0,train
1587,0507862_sc-224580.jpg,1,0,1,0,2,0,val
1588,0507816_as-0026471.jpg,0,0,1,1,2,0,test
1589,0507917_as-0018473.jpg,1,0,0,0,1,0,train
1590,0507909_as-0031587.jpg,1,0,1,1,3,0,train
1591,0507897_as-0075828.jpg,2,1,0,1,4,0,train
1592,0507901_as-0040857.jpg,2,0,0,1,3,0,train
1593,0507872_as-0011702.jpg,2,0,0,0,2,0,train
1594,0507867_as-0011702.jpg,1,1,1,0,3,0,val
1595,0507880_as-0031052.jpg,2,0,0,1,3,0,test
1596,0507856_as-0015877.jpg,5,0,0,1,6,0,train
1597,0507883_as-2976605.jpg,1,0,1,1,3,0,train
1598,0507895_as-0075828.jpg,2,0,0,0,2,0,train
1599,0507894_as-0075828.jpg,1,0,0,0,1,0,train
1600,0507873_as-0011702.jpg,3,1,1,1,6,0,train
1601,0507842_as-0074172.jpg,1,0,0,0,1,0,val
1602,0507836_as-0078182.jpg,1,0,0,0,1,0,test
1603,0507870_as-0011702.jpg,3,1,0,0,4,0,train
1604,0507902_as-0040857.jpg,1,0,0,0,1,0,train
1605,0507835_as-0078182.jpg,2,0,0,0,2,0,train
1606,0507881_as-0031052.jpg,6,0,0,0,6,0,train
1607,0507859_as-0015877.jpg,3,0,1,1,5,0,train
1608,0507858_as-0015877.jpg,1,0,1,0,2,0,val
1609,0507823_sc-230513.jpg,2,1,0,0,3,0,test
1610,0507854_as-0015877.jpg,2,0,0,0,2,0,train
1611,0507844_as-0074172.jpg,1,3,1,1,6,0,train
1612,0507813_sc-190525.jpg,1,0,1,0,2,0,train
1613,0507837_as-0078182.jpg,5,1,3,2,11,0,train
1614,0507892_sc-106099.jpg,0,1,0,0,1,0,train
1615,0507890_sc-106099.jpg,2,0,0,1,3,0,val
1616,0507896_as-0075828.jpg,1,0,2,0,3,0,test
1617,0507806_sc-153240.jpg,0,1,2,0,3,0,train
1618,0507893_sc-106099.jpg,1,0,0,0,1,0,train
1619,0507927_as-0027917.jpg,6,0,0,0,6,0,train
1620,0507879_as-5256633.jpg,1,0,0,0,1,0,train
1621,0507820_sc-230513.jpg,1,1,1,0,3,0,train
1622,0507850_as-0015877.jpg,2,0,0,1,3,0,val
1623,0507871_as-0011702.jpg,1,0,0,0,1,0,test
1624,0507886_sc-126832.jpg,5,0,2,0,7,0,train
1625,0507843_as-0074172.jpg,1,1,0,0,2,0,train
1626,0507860_sc-224580.jpg,3,0,0,0,3,0,train
1627,0507877_sc-125392.jpg,9,0,0,0,9,0,train
1628,0507827_sc-106887.jpg,1,0,0,1,2,0,train
1629,0507811_sc-190525.jpg,2,2,2,0,6,0,val
1630,0507868_as-0011702.jpg,4,1,2,0,7,0,test
1631,0507878_sc-125392.jpg,4,0,0,0,4,0,train
1632,0507815_as-0026471.jpg,3,0,1,1,5,0,train
1633,0507817_as-0026471.jpg,0,0,0,1,1,0,train
1634,0507847_as-0074172.jpg,1,0,1,0,2,0,train
1635,0507855_as-0015877.jpg,1,0,1,0,2,0,train
1636,0507814_as-2619641.jpg,1,0,2,0,3,0,val
1637,0507840_as-0074172.jpg,3,0,0,0,3,0,test
1638,0507830_sc-160275.jpg,1,0,0,0,1,0,train
1639,0507818_as-0026471.jpg,2,0,0,0,2,0,train
1640,0507851_as-0015877.jpg,1,0,0,0,1,0,train
1641,0507841_as-0074172.jpg,3,0,0,0,3,0,train
1642,0507857_as-0015877.jpg,4,0,0,0,4,0,train
1643,0507853_as-0015877.jpg,6,0,0,0,6,0,val
1644,0507887_sc-126832.jpg,5,0,1,0,6,0,test
1645,0507861_sc-224580.jpg,2,0,0,0,2,0,train
1646,0507784_sc-107882.jpg,2,0,0,1,3,0,train
1647,0507824_sc-230513.jpg,1,0,0,0,1,0,train
1648,0507828_sc-106887.jpg,0,0,1,0,1,0,train
1649,0507852_as-0015877.jpg,2,0,0,0,2,0,train
1650,0507829_as-3289072.jpg,1,0,1,1,3,0,val
1651,0507745_as-0052549.jpg,1,0,1,1,3,0,test
1652,0507741_as-9028103.jpg,0,0,1,0,1,0,train
1653,0507754_sc-225693.jpg,3,0,1,0,4,0,train
1654,0507869_as-0011702.jpg,0,0,0,1,1,0,train
1655,0507821_sc-230513.jpg,0,0,2,0,2,0,train
1656,0507753_sc-225693.jpg,2,0,0,1,3,0,train
1657,0508180_sc-128826.jpg,1,2,0,0,3,0,val
1658,0507822_sc-230513.jpg,3,0,0,0,3,0,test
1659,0508167_as-0059219.jpg,3,0,0,0,3,0,train
1660,0507759_sc-214359.jpg,3,0,0,1,4,0,train
1661,0508172_as-0059219.jpg,2,0,1,0,3,0,train
1662,0508189_sc-1017331.jpg,2,0,0,0,2,0,train
1663,0508202_sc-206972.jpg,1,0,0,0,1,0,train
1664,0507888_as-3305111.jpg,1,0,0,0,1,0,val
1665,0508219_as-0038959.jpg,1,0,0,0,1,0,test
1666,0508196_as-0084837.jpg,2,1,1,0,4,0,train
1667,0508173_as-0059219.jpg,2,0,0,0,2,0,train
1668,0508175_as-3378780.jpg,1,0,0,1,2,0,train
1669,0508174_as-0059219.jpg,4,0,0,0,4,0,train
1670,0508186_sc-196273.jpg,4,0,1,0,5,0,train
1671,0508221_as-0038959.jpg,3,1,0,0,4,0,val
1672,0508162_as-0059219.jpg,2,1,0,0,3,0,test
1673,0508220_as-0038959.jpg,0,1,0,2,3,0,train
1674,0508217_sc-1013406.jpg,2,0,0,1,3,0,train
1675,0508206_sc-206972.jpg,3,0,1,0,4,0,train
1676,0508164_as-0059219.jpg,1,0,1,0,2,0,train
1677,0508170_as-0059219.jpg,0,0,1,0,1,0,train
1678,0508224_as-0038959.jpg,1,0,0,0,1,0,val
1679,0507798_sc-156319.jpg,2,0,0,1,3,0,test
1680,0507746_as-0052549.jpg,2,0,1,0,3,0,train
1681,0507781_sc-107882.jpg,2,0,3,2,7,0,train
1682,0507748_as-0052549.jpg,3,0,0,0,3,0,train
1683,0507747_as-0052549.jpg,6,1,0,1,8,0,train
1684,0507750_as-0052549.jpg,0,2,1,0,3,0,train
1685,0507755_sc-225693.jpg,2,0,4,0,6,0,val
1686,0507758_sc-225693.jpg,2,0,0,0,2,0,test
1687,0507757_sc-225693.jpg,2,0,0,1,3,0,train
1688,0507793_as-0033096.jpg,1,0,0,0,1,0,train
1689,0507744_as-0052549.jpg,0,1,0,0,1,0,train
1690,0507734_as-0014971.jpg,1,0,0,0,1,0,train
1691,0507772_as-0029426.jpg,3,2,5,1,11,0,train
1692,0507792_as-0087899.jpg,0,1,0,0,1,0,val
1693,0507768_sc-122938.jpg,1,0,0,0,1,0,test
1694,0507769_as-3367568.jpg,1,0,0,0,1,0,train
1695,0507794_as-0033096.jpg,1,0,0,0,1,0,train
1696,0507771_as-0029426.jpg,2,1,1,1,5,0,train
1697,0507736_as-0014971.jpg,6,0,0,0,6,0,train
1698,0507751_as-0052549.jpg,0,0,0,1,1,0,train
1699,0507779_sc-107882.jpg,2,0,0,0,2,0,val
1700,0507762_sc-214359.jpg,9,0,0,1,10,0,test
1701,0507767_sc-122938.jpg,3,0,0,0,3,0,train
1702,0507791_as-0087899.jpg,3,0,0,0,3,0,train
1703,0507729_as-7544730.jpg,1,0,0,1,2,0,train
1704,0507780_sc-107882.jpg,1,0,1,0,2,0,train
1705,0507766_sc-217825.jpg,1,0,0,0,1,0,train
1706,0507763_sc-214359.jpg,0,0,1,0,1,0,val
1707,0507731_as-0014971.jpg,3,0,0,0,3,0,test
1708,0507765_sc-217825.jpg,2,0,0,0,2,0,train
1709,0507752_as-7350847.jpg,1,1,0,0,2,0,train
1710,0507739_as-9051387.jpg,1,0,0,0,1,0,train
1711,0507749_as-0052549.jpg,2,1,0,1,4,0,train
1712,0507782_sc-107882.jpg,3,1,1,2,7,0,train
1713,0507764_sc-214359.jpg,1,0,1,0,2,0,val
1714,0507760_sc-214359.jpg,2,2,1,0,5,0,test
1715,0507787_as-0059788.jpg,5,0,0,0,5,0,train
1716,0507783_sc-107882.jpg,1,0,0,0,1,0,train
1717,0507790_sc-126720.jpg,1,0,0,0,1,0,train
1718,0507797_sc-156319.jpg,1,0,1,0,2,0,train
1719,0507737_as-0014971.jpg,2,0,1,2,5,0,train
1720,0507676_as-0089445.jpg,5,0,0,0,5,0,val
1721,0507690_as-0069098.jpg,2,0,0,0,2,0,test
1722,0507696_as-3139073.jpg,14,0,0,0,14,0,train
1723,0507775_sc-173877.jpg,2,0,0,1,3,0,train
1724,0507756_sc-225693.jpg,1,0,1,0,2,0,train
1725,0507761_sc-214359.jpg,1,0,0,0,1,0,train
1726,0507684_as-0093379.jpg,1,0,0,1,2,0,train
1727,0507716_sc-1032776.jpg,0,0,0,1,1,0,val
1728,0507691_as-0069098.jpg,4,0,0,1,5,0,test
1729,0507801_as-9078963.jpg,1,1,1,0,3,0,train
1730,0507719_sc-1026128.jpg,2,1,0,1,4,0,train
1731,0507721_sc-1026128.jpg,2,1,2,0,5,0,train
1732,0507725_as-0077541.jpg,1,2,0,0,3,0,train
1733,0507714_sc-1032776.jpg,2,0,0,2,4,0,train
1734,0507698_as-0013597.jpg,8,0,0,0,8,0,val
1735,0507688_as-0069098.jpg,3,0,0,1,4,0,test
1736,0507717_sc-1026128.jpg,1,0,1,0,2,0,train
1737,0507701_sc-133005.jpg,1,0,1,1,3,0,train
1738,0507675_as-0089445.jpg,0,1,1,0,2,0,train
1739,0507687_as-0069098.jpg,2,0,1,0,3,0,train
1740,0507695_as-3139073.jpg,4,0,0,0,4,0,train
1741,0507712_sc-1032776.jpg,1,0,1,0,2,0,val
1742,0507700_sc-133005.jpg,0,0,0,1,1,0,test
1743,0507683_as-0093379.jpg,2,0,0,0,2,0,train
1744,0507720_sc-1026128.jpg,1,0,0,0,1,0,train
1745,0507689_as-0069098.jpg,1,0,0,0,1,0,train
1746,0507705_as-2714596.jpg,1,0,0,0,1,0,train
1747,0507693_as-2663423.jpg,1,0,0,1,2,0,train
1748,0507711_sc-1032776.jpg,1,0,2,0,3,0,val
1749,0507685_as-0093379.jpg,3,2,3,0,8,0,test
1750,0507726_as-0077541.jpg,9,0,0,1,10,0,train
1751,0507680_as-0095073.jpg,1,0,0,0,1,0,train
1752,0507694_as-0071271.jpg,5,0,0,0,5,0,train
1753,0507702_sc-1000449.jpg,2,0,1,0,3,0,train
1754,0507678_as-2945897.jpg,1,0,0,0,1,0,train
1755,0507679_as-0095073.jpg,1,0,0,1,2,0,val
1756,0507723_as-0000043.jpg,0,1,0,0,1,0,test
1757,0507724_as-0077541.jpg,1,0,0,0,1,0,train
1758,0507708_sc-1015942.jpg,3,0,0,0,3,0,train
1759,0507677_as-0089445.jpg,1,0,0,0,1,0,train
1760,0507728_as-2601998.jpg,1,0,0,0,1,0,train
1761,0507699_as-0013597.jpg,1,0,0,0,1,0,train
1762,0507654_sc-189766.jpg,2,0,0,0,2,0,val
1763,0507706_as-3307381.jpg,2,0,0,0,2,0,test
1764,0507649_as-0008483.jpg,3,1,0,0,4,0,train
1765,0507657_as-3292236.jpg,2,0,0,0,2,0,train
1766,0507718_sc-1026128.jpg,6,0,1,0,7,0,train
1767,0507658_as-9025484.jpg,3,0,0,0,3,0,train
1768,0507709_sc-1015942.jpg,1,0,0,0,1,0,train
1769,0507648_as-0008483.jpg,3,0,1,1,5,0,val
1770,0507661_as-0094420.jpg,1,0,1,0,2,0,test
1771,0507638_as-5152886.jpg,2,0,0,0,2,0,train
1772,0507642_as-0022571.jpg,1,0,0,0,1,0,train
1773,0507667_sc-221901.jpg,1,0,1,0,2,0,train
1774,0507655_as-3292236.jpg,1,1,1,0,3,0,train
1775,0507639_as-0022571.jpg,4,0,0,0,4,0,train
1776,0507668_sc-221901.jpg,1,0,0,1,2,0,val
1777,0507636_sc-120120.jpg,1,0,0,0,1,0,test
1778,0507666_sc-221901.jpg,1,0,0,0,1,0,train
1779,0507671_sc-221901.jpg,2,0,2,2,6,0,train
1780,0507656_as-3292236.jpg,2,1,1,1,5,0,train
1781,0507670_sc-221901.jpg,3,0,0,2,5,0,train
1782,0507652_as-3417657.jpg,1,0,0,0,1,0,train
1783,0507641_as-0022571.jpg,1,0,0,0,1,0,val
1784,0507663_as-0094420.jpg,2,1,0,0,3,0,test
1785,0507632_as-0034117.jpg,1,0,0,0,1,0,train
1786,0507672_as-2838725.jpg,2,0,2,1,5,0,train
1787,0507643_as-0022571.jpg,1,0,0,0,1,0,train
1788,0507635_as-0099954.jpg,5,0,0,0,5,0,train
1789,0507665_sc-221901.jpg,4,0,1,1,6,0,train
1790,0507647_as-0063030.jpg,1,0,1,0,2,0,val
1791,0507669_sc-221901.jpg,3,0,0,0,3,0,test
1792,0507646_as-0063030.jpg,1,0,0,1,2,0,train
1793,0507640_as-0022571.jpg,1,0,0,0,1,0,train
1794,0507585_sc-1020260.jpg,0,1,0,0,1,0,train
1795,0507609_sc-162996.jpg,4,1,0,0,5,0,train
1796,0507624_as-2633454.jpg,4,1,1,0,6,0,train
1797,0507614_as-0097321.jpg,2,0,0,0,2,0,val
1798,0507651_as-0033471.jpg,1,0,0,0,1,0,test
1799,0507583_as-3345558.jpg,12,1,1,0,14,0,train
1800,0507626_as-0030134.jpg,7,0,3,1,11,0,train
1801,0507563_sc-228092.jpg,2,0,0,0,2,0,train
1802,0507587_sc-1020260.jpg,1,0,0,0,1,0,train
1803,0507591_as-0099538.jpg,1,0,0,0,1,0,train
1804,0507582_as-3345558.jpg,1,0,0,0,1,0,val
1805,0507577_as-0085061.jpg,1,0,1,2,4,0,test
1806,0507565_sc-228092.jpg,1,0,0,0,1,0,train
1807,0507571_as-5017435.jpg,0,0,1,1,2,0,train
1808,0507625_as-0030134.jpg,5,0,1,0,6,0,train
1809,0507600_as-0053769.jpg,5,1,0,0,6,0,train
1810,0507581_as-0085061.jpg,1,0,2,1,4,0,train
1811,0507578_as-0085061.jpg,1,0,0,0,1,0,val
1812,0507599_as-0053769.jpg,1,0,0,1,2,0,test
1813,0507629_as-0034117.jpg,1,0,0,0,1,0,train
1814,0507616_as-0097321.jpg,2,0,0,0,2,0,train
1815,0507631_as-0034117.jpg,1,0,0,0,1,0,train
1816,0507579_as-0085061.jpg,1,0,0,0,1,0,train
1817,0507623_as-0034309.jpg,0,0,1,0,1,0,train
1818,0507557_sc-228092.jpg,2,1,1,0,4,0,val
1819,0507560_sc-228092.jpg,3,0,0,1,4,0,test
1820,0507558_sc-228092.jpg,1,0,1,0,2,0,train
1821,0507604_as-0096102.jpg,1,0,0,0,1,0,train
1822,0507617_as-0097321.jpg,1,0,0,0,1,0,train
1823,0507627_as-2883202.jpg,3,0,1,1,5,0,train
1824,0507568_sc-228092.jpg,1,0,0,0,1,0,train
1825,0507601_as-0053769.jpg,2,0,0,0,2,0,val
1826,0507570_sc-228092.jpg,1,0,0,0,1,0,test
1827,0507607_sc-162996.jpg,7,0,1,0,8,0,train
1828,0507620_as-0097321.jpg,1,0,0,0,1,0,train
1829,0507556_sc-228092.jpg,3,0,0,0,3,0,train
1830,0507628_as-0034117.jpg,0,0,1,0,1,0,train
1831,0507561_sc-228092.jpg,2,0,0,0,2,0,train
1832,0507589_as-2992217.jpg,0,0,1,0,1,0,val
1833,0507576_as-0085061.jpg,4,0,0,0,4,0,test
1834,0507584_sc-1020260.jpg,1,0,0,0,1,0,train
1835,0507595_as-0056635.jpg,1,0,0,0,1,0,train
1836,0507567_sc-228092.jpg,1,1,0,0,2,0,train
1837,0507575_as-0025103.jpg,1,0,4,1,6,0,train
1838,0507572_as-2889967.jpg,3,0,0,0,3,0,train
1839,0507569_sc-228092.jpg,4,1,0,2,7,0,val
1840,0507588_sc-1038480.jpg,2,0,0,0,2,0,test
1841,0507619_as-0097321.jpg,1,0,0,0,1,0,train
1842,0507621_as-9022671.jpg,1,0,0,0,1,0,train
1843,0507562_sc-228092.jpg,2,0,0,1,3,0,train
1844,0507566_sc-228092.jpg,0,0,1,2,3,0,train
1845,0507573_as-0029853.jpg,0,0,1,0,1,0,train
1846,0507605_sc-184600.jpg,3,0,0,0,3,0,val
1847,0507608_sc-162996.jpg,0,0,1,0,1,0,test
1848,0507559_sc-228092.jpg,1,0,0,0,1,0,train
1849,0507586_sc-1020260.jpg,3,0,0,1,4,0,train
1850,0507555_sc-228092.jpg,0,0,0,1,1,0,train
1851,0507580_as-0085061.jpg,2,0,0,0,2,0,train
1852,0507615_as-0097321.jpg,6,1,1,0,8,0,train
1853,0507611_sc-1029401.jpg,1,0,1,1,3,0,val
1854,0507574_as-0029853.jpg,2,0,1,1,4,0,test
1855,0507612_as-0097321.jpg,0,1,0,0,1,0,train
1856,0507517_as-0098013.jpg,3,2,0,0,5,0,train
1857,0507542_sc-136096.jpg,1,0,0,0,1,0,train
1858,0507593_as-0056635.jpg,3,0,0,0,3,0,train
1859,0507531_sc-191272.jpg,1,0,0,0,1,0,train
1860,0507630_as-0034117.jpg,1,0,0,0,1,0,val
1861,0507532_sc-169363.jpg,1,0,0,0,1,0,test
1862,0507486_sc-179050.jpg,3,0,1,1,5,0,train
1863,0508210_sc-206972.jpg,0,0,1,0,1,0,train
1864,0507564_sc-228092.jpg,1,2,1,0,4,0,train
1865,0507516_as-0098013.jpg,3,0,0,0,3,0,train
1866,0507506_as-0016093.jpg,1,1,1,1,4,0,train
1867,0508156_sc-103051.jpg,3,0,0,0,3,0,val
1868,0507515_as-0098013.jpg,5,0,0,0,5,0,test
1869,0507490_sc-179050.jpg,0,0,1,0,1,0,train
1870,0507553_sc-1012726.jpg,1,0,0,0,1,0,train
1871,0507496_sc-179050.jpg,1,0,1,0,2,0,train
1872,0508199_as-0084837.jpg,2,0,0,0,2,0,train
1873,0508201_sc-206972.jpg,4,0,0,0,4,0,train
1874,0507513_as-0098013.jpg,1,0,1,1,3,0,val
1875,0508214_sc-206972.jpg,5,0,0,1,6,0,test
1876,0507493_sc-179050.jpg,1,0,0,0,1,0,train
1877,0507488_sc-179050.jpg,1,0,0,1,2,0,train
1878,0507485_sc-229757.jpg,3,0,0,0,3,0,train
1879,0508213_sc-206972.jpg,1,0,0,1,2,0,train
1880,0507539_as-0074354.jpg,6,1,2,2,11,0,train
1881,0507520_sc-195094.jpg,5,0,0,0,5,0,val
1882,0508195_as-0084837.jpg,1,0,2,4,7,0,test
1883,0508204_sc-206972.jpg,1,0,0,0,1,0,train
1884,0508198_as-0084837.jpg,3,0,0,0,3,0,train
1885,0508223_as-0038959.jpg,6,0,1,0,7,0,train
1886,0507491_sc-179050.jpg,1,1,0,0,2,0,train
1887,0508190_sc-1017331.jpg,1,0,0,0,1,0,train
1888,0507499_sc-179050.jpg,2,0,3,2,7,0,val
1889,0508182_sc-107666.jpg,2,0,0,0,2,0,test
1890,0507511_as-0098013.jpg,1,0,0,0,1,0,train
1891,0507503_as-0016093.jpg,0,0,1,0,1,0,train
1892,0508158_sc-103051.jpg,1,1,0,0,2,0,train
1893,0507489_sc-179050.jpg,2,1,1,0,4,0,train
1894,0507504_as-0016093.jpg,1,1,1,2,5,0,train
1895,0508208_sc-206972.jpg,0,0,1,0,1,0,val
1896,0508178_as-3115329.jpg,1,1,0,0,2,0,test
1897,0507538_as-0074354.jpg,1,0,2,1,4,0,train
1898,0507537_as-0074354.jpg,3,1,1,1,6,0,train
1899,0508200_as-2611730.jpg,2,0,0,0,2,0,train
1900,0508194_as-0084837.jpg,1,0,0,0,1,0,train
1901,0507519_sc-195094.jpg,1,0,1,0,2,0,train
1902,0508176_as-7308144.jpg,0,1,1,0,2,0,val
1903,0507528_sc-191272.jpg,3,0,0,0,3,0,test
1904,0508163_as-0059219.jpg,2,0,0,0,2,0,train
1905,0507508_as-0016093.jpg,0,0,1,1,2,0,train
1906,0507495_sc-179050.jpg,0,0,2,0,2,0,train
1907,0508212_sc-206972.jpg,0,1,0,1,2,0,train
1908,0507487_sc-179050.jpg,5,0,0,0,5,0,train
1909,0508171_as-0059219.jpg,4,1,1,0,6,0,val
1910,0508225_as-0038959.jpg,0,0,1,0,1,0,test
1911,0507505_as-0016093.jpg,1,0,1,1,3,0,train
1912,0507540_as-0074354.jpg,0,1,0,0,1,0,train
1913,0508165_as-0059219.jpg,2,0,1,3,6,0,train
1914,0507549_sc-1005830.jpg,1,0,0,0,1,0,train
1915,0507522_sc-195094.jpg,1,0,0,0,1,0,train
1916,0508203_sc-206972.jpg,1,0,0,0,1,0,val
1917,0508205_sc-206972.jpg,1,1,1,0,3,0,test
1918,0508222_as-0038959.jpg,1,0,1,2,4,0,train
1919,0507544_sc-219462.jpg,1,4,2,2,9,0,train
1920,0507483_as-0083338.jpg,3,0,0,0,3,0,train
1921,0507498_sc-179050.jpg,3,0,1,2,6,0,train
1922,0508215_sc-206972.jpg,9,1,1,0,11,0,train
1923,0508211_sc-206972.jpg,8,0,0,0,8,0,val
1924,0508187_sc-1017331.jpg,2,0,0,0,2,0,test
1925,0507492_sc-179050.jpg,1,0,0,0,1,0,train
1926,0507481_as-0037985.jpg,3,0,0,0,3,0,train
1927,0508197_as-0084837.jpg,4,0,0,0,4,0,train
1928,0508207_sc-206972.jpg,2,0,1,0,3,0,train
1929,0507521_sc-195094.jpg,1,0,1,0,2,0,train
1930,0508185_sc-196273.jpg,3,0,0,0,3,0,val
1931,0507548_sc-1005830.jpg,1,0,1,1,3,0,test
1932,0508177_sc-225646.jpg,0,0,1,0,1,0,train
1933,0508183_sc-107666.jpg,1,2,2,0,5,0,train
1934,0507530_sc-191272.jpg,0,0,2,0,2,0,train
1935,0507509_sc-127519.jpg,1,0,0,0,1,0,train
1936,0508169_as-0059219.jpg,1,0,0,1,2,0,train
1937,0507550_as-7883012.jpg,3,0,0,0,3,0,val
1938,0508209_sc-206972.jpg,0,0,1,0,1,0,test
1939,0508179_as-0009508.jpg,1,0,1,1,3,0,train
1940,0507484_as-2767377.jpg,1,0,0,0,1,0,train
1941,0508157_sc-103051.jpg,4,0,0,0,4,0,train
1942,0507536_as-0074354.jpg,1,0,0,0,1,0,train
1943,0507527_sc-1022589.jpg,0,0,2,0,2,0,train
1944,0507507_as-0016093.jpg,2,0,0,0,2,0,val
1945,0507541_as-0074354.jpg,1,1,2,0,4,0,test
1946,0508134_as-0057740.jpg,0,0,1,0,1,0,train
1947,0507426_sc-181541.jpg,1,1,0,0,2,0,train
1948,0508122_sc-1033015.jpg,4,2,0,0,6,0,train
1949,0507535_as-0074354.jpg,2,1,4,2,9,0,train
1950,0507425_sc-181541.jpg,2,0,0,0,2,0,train
1951,0507437_as-3194988.jpg,1,0,0,0,1,0,val
1952,0507421_sc-1040741.jpg,2,0,0,1,3,0,test
1953,0507478_as-3147515.jpg,3,0,0,1,4,0,train
1954,0507452_as-0046949.jpg,5,0,0,0,5,0,train
1955,0507416_sc-104825.jpg,1,1,0,0,2,0,train
1956,0507419_as-0067779.jpg,1,0,0,0,1,0,train
1957,0507460_sc-227088.jpg,1,0,0,1,2,0,train
1958,0507477_sc-196898.jpg,3,0,0,0,3,0,val
1959,0507475_as-3388360.jpg,2,0,2,0,4,0,test
1960,0507446_as-0046949.jpg,1,0,1,0,2,0,train
1961,0507440_sc-1038127.jpg,4,0,1,0,5,0,train
1962,0507479_sc-217764.jpg,4,0,2,0,6,0,train
1963,0507417_sc-196460.jpg,2,0,0,0,2,0,train
1964,0507457_as-7223104.jpg,1,0,0,0,1,0,train
1965,0507462_sc-227088.jpg,7,0,0,0,7,0,val
1966,0507409_sc-1023808.jpg,1,1,0,0,2,0,test
1967,0507449_as-0046949.jpg,1,0,1,1,3,0,train
1968,0507471_sc-1021680.jpg,1,0,2,0,3,0,train
1969,0507410_sc-1023808.jpg,3,0,0,0,3,0,train
1970,0507433_sc-194890.jpg,6,0,0,1,7,0,train
1971,0507407_as-2559165.jpg,1,0,0,0,1,0,train
1972,0507438_as-2529589.jpg,1,0,0,2,3,0,val
1973,0507480_as-0037985.jpg,3,2,2,1,8,0,test
1974,0507430_as-7372848.jpg,3,0,0,0,3,0,train
1975,0507428_sc-181541.jpg,0,1,1,0,2,0,train
1976,0507455_as-0046949.jpg,1,0,1,0,2,0,train
1977,0507423_sc-1040741.jpg,2,0,0,0,2,0,train
1978,0507450_as-0046949.jpg,3,0,0,0,3,0,train
1979,0507456_as-0030535.jpg,2,0,0,0,2,0,val
1980,0507472_sc-1021680.jpg,2,0,0,0,2,0,test
1981,0507441_sc-1038127.jpg,3,0,1,2,6,0,train
1982,0507412_sc-1023808.jpg,3,0,0,1,4,0,train
1983,0507476_sc-196898.jpg,4,0,1,0,5,0,train
1984,0507453_as-0046949.jpg,2,1,0,0,3,0,train
1985,0507470_sc-1021680.jpg,4,2,3,0,9,0,train
1986,0507424_as-9098118.jpg,0,1,0,0,1,0,val
1987,0507461_sc-227088.jpg,5,0,0,0,5,0,test
1988,0507466_as-0093959.jpg,2,1,0,1,4,0,train
1989,0507464_as-0093959.jpg,2,0,0,0,2,0,train
1990,0507465_as-0093959.jpg,1,0,0,0,1,0,train
1991,0507442_as-0011294.jpg,1,0,1,0,2,0,train
1992,0507448_as-0046949.jpg,2,0,1,0,3,0,train
1993,0507411_sc-1023808.jpg,4,0,0,0,4,0,val
1994,0507447_as-0046949.jpg,2,0,0,0,2,0,test
1995,0507397_sc-1032424.jpg,1,0,0,1,2,0,train
1996,0507467_as-7627054.jpg,1,0,0,0,1,0,train
1997,0507366_sc-119819.jpg,1,1,1,1,4,0,train
1998,0507436_sc-194890.jpg,3,0,0,0,3,0,train
1999,0507393_as-0041940.jpg,3,0,0,0,3,0,train
